event_date,event_name,event_name_long,price_code,old_value,new_value,price_delta,upd_datetime,price_change_seq
5/22/2021,20PNR1GA,2021 NBA Playoffs - Round 1 - Home Game A,1,0,236500,236500,32:39.7,1
5/22/2021,20PNR1GA,2021 NBA Playoffs - Round 1 - Home Game A,1,236500,157500,-79000,16:36.2,2
5/22/2021,20PNR1GA,2021 NBA Playoffs - Round 1 - Home Game A,1,157500,6050,-151450,41:36.9,3
5/22/2021,20PNR1GA,2021 NBA Playoffs - Round 1 - Home Game A,1,6050,1100,-4950,52:05.3,4
5/22/2021,20PNR1GA,2021 NBA Playoffs - Round 1 - Home Game A,1,1100,6500,5400,52:12.3,5
5/22/2021,20PNR1GA,2021 NBA Playoffs - Round 1 - Home Game A,1,6500,8000,1500,52:18.8,6
5/22/2021,20PNR1GA,2021 NBA Playoffs - Round 1 - Home Game A,2,0,98900,98900,32:39.8,1
5/22/2021,20PNR1GA,2021 NBA Playoffs - Round 1 - Home Game A,2,98900,6050,-92850,42:45.7,2
5/22/2021,20PNR1GA,2021 NBA Playoffs - Round 1 - Home Game A,2,6050,1100,-4950,52:05.3,3
5/22/2021,20PNR1GA,2021 NBA Playoffs - Round 1 - Home Game A,2,1100,6500,5400,52:12.3,4
5/22/2021,20PNR1GA,2021 NBA Playoffs - Round 1 - Home Game A,2,6500,8000,1500,52:18.8,5
5/22/2021,20PNR1GA,2021 NBA Playoffs - Round 1 - Home Game A,3,0,85979,85979,32:39.9,1
5/22/2021,20PNR1GA,2021 NBA Playoffs - Round 1 - Home Game A,3,85979,157500,71521,16:36.3,2
5/22/2021,20PNR1GA,2021 NBA Playoffs - Round 1 - Home Game A,3,157500,6050,-151450,42:45.7,3
5/22/2021,20PNR1GA,2021 NBA Playoffs - Round 1 - Home Game A,3,6050,1100,-4950,52:05.3,4
5/22/2021,20PNR1GA,2021 NBA Playoffs - Round 1 - Home Game A,3,1100,6500,5400,52:12.3,5
5/22/2021,20PNR1GA,2021 NBA Playoffs - Round 1 - Home Game A,3,6500,8000,1500,52:18.8,6
5/22/2021,20PNR1GA,2021 NBA Playoffs - Round 1 - Home Game A,4,0,47300,47300,32:40.0,1
5/22/2021,20PNR1GA,2021 NBA Playoffs - Round 1 - Home Game A,4,47300,114540,67240,16:36.4,2
5/22/2021,20PNR1GA,2021 NBA Playoffs - Round 1 - Home Game A,4,114540,6050,-108490,42:45.8,3
5/22/2021,20PNR1GA,2021 NBA Playoffs - Round 1 - Home Game A,4,6050,4400,-1650,34:56.5,4
5/22/2021,20PNR1GA,2021 NBA Playoffs - Round 1 - Home Game A,4,4400,1100,-3300,52:05.3,5
5/22/2021,20PNR1GA,2021 NBA Playoffs - Round 1 - Home Game A,4,1100,6500,5400,52:12.3,6
5/22/2021,20PNR1GA,2021 NBA Playoffs - Round 1 - Home Game A,4,6500,8000,1500,52:18.8,7
5/22/2021,20PNR1GA,2021 NBA Playoffs - Round 1 - Home Game A,5,0,43000,43000,32:40.1,1
5/22/2021,20PNR1GA,2021 NBA Playoffs - Round 1 - Home Game A,5,43000,59120,16120,16:36.5,2
5/22/2021,20PNR1GA,2021 NBA Playoffs - Round 1 - Home Game A,5,59120,1960,-57160,42:45.9,3
5/22/2021,20PNR1GA,2021 NBA Playoffs - Round 1 - Home Game A,5,1960,1820,-140,54:56.8,4
5/22/2021,20PNR1GA,2021 NBA Playoffs - Round 1 - Home Game A,5,1960,1820,-140,54:56.8,5
5/22/2021,20PNR1GA,2021 NBA Playoffs - Round 1 - Home Game A,5,1820,1100,-720,52:05.3,6
5/22/2021,20PNR1GA,2021 NBA Playoffs - Round 1 - Home Game A,5,1100,4500,3400,52:12.3,7
5/22/2021,20PNR1GA,2021 NBA Playoffs - Round 1 - Home Game A,6,0,30100,30100,32:40.2,1
5/22/2021,20PNR1GA,2021 NBA Playoffs - Round 1 - Home Game A,6,30100,41100,11000,16:36.6,2
5/22/2021,20PNR1GA,2021 NBA Playoffs - Round 1 - Home Game A,6,41100,1360,-39740,42:45.9,3
5/22/2021,20PNR1GA,2021 NBA Playoffs - Round 1 - Home Game A,6,1360,1100,-260,52:05.3,4
5/22/2021,20PNR1GA,2021 NBA Playoffs - Round 1 - Home Game A,6,1100,2920,1820,52:12.3,5
5/22/2021,20PNR1GA,2021 NBA Playoffs - Round 1 - Home Game A,7,23650,38610,14960,16:36.7,1
5/22/2021,20PNR1GA,2021 NBA Playoffs - Round 1 - Home Game A,7,38610,1280,-37330,42:46.0,2
5/22/2021,20PNR1GA,2021 NBA Playoffs - Round 1 - Home Game A,7,1280,1325,45,54:56.8,3
5/22/2021,20PNR1GA,2021 NBA Playoffs - Round 1 - Home Game A,7,1280,1325,45,54:56.8,4
5/22/2021,20PNR1GA,2021 NBA Playoffs - Round 1 - Home Game A,7,1325,1100,-225,52:05.3,5
5/22/2021,20PNR1GA,2021 NBA Playoffs - Round 1 - Home Game A,7,1100,2100,1000,52:12.3,6
5/22/2021,20PNR1GA,2021 NBA Playoffs - Round 1 - Home Game A,7,2100,1200,-900,52:06.0,7
5/22/2021,20PNR1GA,2021 NBA Playoffs - Round 1 - Home Game A,7,1200,870,-330,52:09.3,8
5/22/2021,20PNR1GA,2021 NBA Playoffs - Round 1 - Home Game A,8,18275,32420,14145,16:36.7,1
5/22/2021,20PNR1GA,2021 NBA Playoffs - Round 1 - Home Game A,8,32420,930,-31490,42:46.0,2
5/22/2021,20PNR1GA,2021 NBA Playoffs - Round 1 - Home Game A,8,930,1100,170,52:05.3,3
5/22/2021,20PNR1GA,2021 NBA Playoffs - Round 1 - Home Game A,8,1100,1270,170,52:06.9,4
5/22/2021,20PNR1GA,2021 NBA Playoffs - Round 1 - Home Game A,8,1270,1910,640,52:05.9,5
5/22/2021,20PNR1GA,2021 NBA Playoffs - Round 1 - Home Game A,8,1910,1720,-190,52:05.8,6
5/22/2021,20PNR1GA,2021 NBA Playoffs - Round 1 - Home Game A,8,1720,1550,-170,52:09.2,7
5/22/2021,20PNR1GA,2021 NBA Playoffs - Round 1 - Home Game A,8,1550,1440,-110,52:06.1,8
5/22/2021,20PNR1GA,2021 NBA Playoffs - Round 1 - Home Game A,8,1440,1720,280,52:05.3,9
5/22/2021,20PNR1GA,2021 NBA Playoffs - Round 1 - Home Game A,8,1720,670,-1050,52:09.3,10
5/22/2021,20PNR1GA,2021 NBA Playoffs - Round 1 - Home Game A,9,17630,31260,13630,16:36.8,1
5/22/2021,20PNR1GA,2021 NBA Playoffs - Round 1 - Home Game A,9,31260,895,-30365,42:46.1,2
5/22/2021,20PNR1GA,2021 NBA Playoffs - Round 1 - Home Game A,9,895,1100,205,52:05.3,3
5/22/2021,20PNR1GA,2021 NBA Playoffs - Round 1 - Home Game A,9,1100,1230,130,52:06.9,4
5/22/2021,20PNR1GA,2021 NBA Playoffs - Round 1 - Home Game A,9,1230,1850,620,52:05.9,5
5/22/2021,20PNR1GA,2021 NBA Playoffs - Round 1 - Home Game A,9,1850,1650,-200,52:05.8,6
5/22/2021,20PNR1GA,2021 NBA Playoffs - Round 1 - Home Game A,9,1650,1480,-170,52:09.2,7
5/22/2021,20PNR1GA,2021 NBA Playoffs - Round 1 - Home Game A,9,1480,1370,-110,52:06.1,8
5/22/2021,20PNR1GA,2021 NBA Playoffs - Round 1 - Home Game A,9,1370,1650,280,52:05.3,9
5/22/2021,20PNR1GA,2021 NBA Playoffs - Round 1 - Home Game A,9,1650,645,-1005,52:09.3,10
5/22/2021,20PNR1GA,2021 NBA Playoffs - Round 1 - Home Game A,A,0,16770,16770,32:40.3,1
5/22/2021,20PNR1GA,2021 NBA Playoffs - Round 1 - Home Game A,A,16770,29570,12800,16:36.9,2
5/22/2021,20PNR1GA,2021 NBA Playoffs - Round 1 - Home Game A,A,29570,845,-28725,42:58.1,3
5/22/2021,20PNR1GA,2021 NBA Playoffs - Round 1 - Home Game A,A,845,1100,255,52:05.3,4
5/22/2021,20PNR1GA,2021 NBA Playoffs - Round 1 - Home Game A,A,1100,985,-115,52:04.9,5
5/22/2021,20PNR1GA,2021 NBA Playoffs - Round 1 - Home Game A,A,985,1230,245,52:05.9,6
5/22/2021,20PNR1GA,2021 NBA Playoffs - Round 1 - Home Game A,A,1230,1270,40,52:05.8,7
5/22/2021,20PNR1GA,2021 NBA Playoffs - Round 1 - Home Game A,A,1270,1160,-110,52:06.9,8
5/22/2021,20PNR1GA,2021 NBA Playoffs - Round 1 - Home Game A,A,1160,1740,580,52:05.9,9
5/22/2021,20PNR1GA,2021 NBA Playoffs - Round 1 - Home Game A,A,1740,1560,-180,52:05.8,10
5/22/2021,20PNR1GA,2021 NBA Playoffs - Round 1 - Home Game A,A,1560,1400,-160,52:09.2,11
5/22/2021,20PNR1GA,2021 NBA Playoffs - Round 1 - Home Game A,A,1400,1290,-110,52:06.1,12
5/22/2021,20PNR1GA,2021 NBA Playoffs - Round 1 - Home Game A,A,1290,1560,270,52:05.3,13
5/22/2021,20PNR1GA,2021 NBA Playoffs - Round 1 - Home Game A,A,1560,595,-965,52:09.3,14
5/22/2021,20PNR1GA,2021 NBA Playoffs - Round 1 - Home Game A,B,0,16125,16125,32:40.4,1
5/22/2021,20PNR1GA,2021 NBA Playoffs - Round 1 - Home Game A,B,16125,26880,10755,16:37.0,2
5/22/2021,20PNR1GA,2021 NBA Playoffs - Round 1 - Home Game A,B,26880,770,-26110,46:19.8,3
5/22/2021,20PNR1GA,2021 NBA Playoffs - Round 1 - Home Game A,B,770,1100,330,52:05.3,4
5/22/2021,20PNR1GA,2021 NBA Playoffs - Round 1 - Home Game A,B,1100,960,-140,52:04.9,5
5/22/2021,20PNR1GA,2021 NBA Playoffs - Round 1 - Home Game A,B,960,1200,240,52:05.9,6
5/22/2021,20PNR1GA,2021 NBA Playoffs - Round 1 - Home Game A,B,1200,1230,30,52:05.8,7
5/22/2021,20PNR1GA,2021 NBA Playoffs - Round 1 - Home Game A,B,1230,1060,-170,52:06.9,8
5/22/2021,20PNR1GA,2021 NBA Playoffs - Round 1 - Home Game A,B,1060,1590,530,52:05.9,9
5/22/2021,20PNR1GA,2021 NBA Playoffs - Round 1 - Home Game A,B,1590,1430,-160,52:05.8,10
5/22/2021,20PNR1GA,2021 NBA Playoffs - Round 1 - Home Game A,B,1430,1290,-140,52:09.2,11
5/22/2021,20PNR1GA,2021 NBA Playoffs - Round 1 - Home Game A,B,1290,1180,-110,52:06.1,12
5/22/2021,20PNR1GA,2021 NBA Playoffs - Round 1 - Home Game A,B,1180,1430,250,52:05.3,13
5/22/2021,20PNR1GA,2021 NBA Playoffs - Round 1 - Home Game A,B,1430,1000,-430,52:06.0,14
5/22/2021,20PNR1GA,2021 NBA Playoffs - Round 1 - Home Game A,B,1000,1300,300,52:05.9,15
5/22/2021,20PNR1GA,2021 NBA Playoffs - Round 1 - Home Game A,B,1300,1100,-200,52:06.0,16
5/22/2021,20PNR1GA,2021 NBA Playoffs - Round 1 - Home Game A,B,1100,450,-650,52:09.3,17
5/22/2021,20PNR1GA,2021 NBA Playoffs - Round 1 - Home Game A,C,0,15050,15050,32:40.5,1
5/22/2021,20PNR1GA,2021 NBA Playoffs - Round 1 - Home Game A,C,15050,24590,9540,16:37.1,2
5/22/2021,20PNR1GA,2021 NBA Playoffs - Round 1 - Home Game A,C,24590,705,-23885,46:19.9,3
5/22/2021,20PNR1GA,2021 NBA Playoffs - Round 1 - Home Game A,C,705,1100,395,52:05.3,4
5/22/2021,20PNR1GA,2021 NBA Playoffs - Round 1 - Home Game A,C,1100,905,-195,52:04.9,5
5/22/2021,20PNR1GA,2021 NBA Playoffs - Round 1 - Home Game A,C,905,1130,225,52:05.9,6
5/22/2021,20PNR1GA,2021 NBA Playoffs - Round 1 - Home Game A,C,1130,1160,30,52:05.8,7
5/22/2021,20PNR1GA,2021 NBA Playoffs - Round 1 - Home Game A,C,1160,975,-185,52:06.9,8
5/22/2021,20PNR1GA,2021 NBA Playoffs - Round 1 - Home Game A,C,975,1470,495,52:05.9,9
5/22/2021,20PNR1GA,2021 NBA Playoffs - Round 1 - Home Game A,C,1470,1320,-150,52:05.8,10
5/22/2021,20PNR1GA,2021 NBA Playoffs - Round 1 - Home Game A,C,1320,1190,-130,52:09.2,11
5/22/2021,20PNR1GA,2021 NBA Playoffs - Round 1 - Home Game A,C,1190,1080,-110,52:06.1,12
5/22/2021,20PNR1GA,2021 NBA Playoffs - Round 1 - Home Game A,C,1080,1320,240,52:05.3,13
5/22/2021,20PNR1GA,2021 NBA Playoffs - Round 1 - Home Game A,C,1320,1150,-170,52:05.9,14
5/22/2021,20PNR1GA,2021 NBA Playoffs - Round 1 - Home Game A,C,1150,990,-160,52:06.0,15
5/22/2021,20PNR1GA,2021 NBA Playoffs - Round 1 - Home Game A,C,990,420,-570,52:09.3,16
5/22/2021,20PNR1GA,2021 NBA Playoffs - Round 1 - Home Game A,D,0,14190,14190,32:40.6,1
5/22/2021,20PNR1GA,2021 NBA Playoffs - Round 1 - Home Game A,D,14190,23530,9340,16:37.2,2
5/22/2021,20PNR1GA,2021 NBA Playoffs - Round 1 - Home Game A,D,23530,675,-22855,46:19.9,3
5/22/2021,20PNR1GA,2021 NBA Playoffs - Round 1 - Home Game A,D,675,1100,425,52:05.3,4
5/22/2021,20PNR1GA,2021 NBA Playoffs - Round 1 - Home Game A,D,1100,825,-275,52:04.9,5
5/22/2021,20PNR1GA,2021 NBA Playoffs - Round 1 - Home Game A,D,825,1030,205,52:05.9,6
5/22/2021,20PNR1GA,2021 NBA Playoffs - Round 1 - Home Game A,D,1030,1060,30,52:05.8,7
5/22/2021,20PNR1GA,2021 NBA Playoffs - Round 1 - Home Game A,D,1060,930,-130,52:06.9,8
5/22/2021,20PNR1GA,2021 NBA Playoffs - Round 1 - Home Game A,D,930,1400,470,52:05.9,9
5/22/2021,20PNR1GA,2021 NBA Playoffs - Round 1 - Home Game A,D,1400,1250,-150,52:05.8,10
5/22/2021,20PNR1GA,2021 NBA Playoffs - Round 1 - Home Game A,D,1250,1120,-130,52:09.2,11
5/22/2021,20PNR1GA,2021 NBA Playoffs - Round 1 - Home Game A,D,1120,1010,-110,52:06.1,12
5/22/2021,20PNR1GA,2021 NBA Playoffs - Round 1 - Home Game A,D,1010,1250,240,52:05.3,13
5/22/2021,20PNR1GA,2021 NBA Playoffs - Round 1 - Home Game A,D,1250,1100,-150,52:05.9,14
5/22/2021,20PNR1GA,2021 NBA Playoffs - Round 1 - Home Game A,D,1100,950,-150,52:06.0,15
5/22/2021,20PNR1GA,2021 NBA Playoffs - Round 1 - Home Game A,D,950,400,-550,52:09.3,16
5/22/2021,20PNR1GA,2021 NBA Playoffs - Round 1 - Home Game A,E,0,13330,13330,32:40.7,1
5/22/2021,20PNR1GA,2021 NBA Playoffs - Round 1 - Home Game A,E,13330,19750,6420,16:37.3,2
5/22/2021,20PNR1GA,2021 NBA Playoffs - Round 1 - Home Game A,E,19750,565,-19185,46:20.0,3
5/22/2021,20PNR1GA,2021 NBA Playoffs - Round 1 - Home Game A,E,565,1750,1185,52:05.3,4
5/22/2021,20PNR1GA,2021 NBA Playoffs - Round 1 - Home Game A,E,1750,755,-995,52:04.9,5
5/22/2021,20PNR1GA,2021 NBA Playoffs - Round 1 - Home Game A,E,755,945,190,52:05.9,6
5/22/2021,20PNR1GA,2021 NBA Playoffs - Round 1 - Home Game A,E,945,975,30,52:05.8,7
5/22/2021,20PNR1GA,2021 NBA Playoffs - Round 1 - Home Game A,E,975,775,-200,52:06.9,8
5/22/2021,20PNR1GA,2021 NBA Playoffs - Round 1 - Home Game A,E,775,1170,395,52:05.9,9
5/22/2021,20PNR1GA,2021 NBA Playoffs - Round 1 - Home Game A,E,1170,1050,-120,52:05.8,10
5/22/2021,20PNR1GA,2021 NBA Playoffs - Round 1 - Home Game A,E,1050,945,-105,52:09.2,11
5/22/2021,20PNR1GA,2021 NBA Playoffs - Round 1 - Home Game A,E,945,860,-85,52:06.1,12
5/22/2021,20PNR1GA,2021 NBA Playoffs - Round 1 - Home Game A,E,860,1050,190,52:05.3,13
5/22/2021,20PNR1GA,2021 NBA Playoffs - Round 1 - Home Game A,E,1050,900,-150,52:06.0,14
5/22/2021,20PNR1GA,2021 NBA Playoffs - Round 1 - Home Game A,E,900,335,-565,52:09.3,15
5/22/2021,20PNR1GA,2021 NBA Playoffs - Round 1 - Home Game A,F,0,11395,11395,32:40.8,1
5/22/2021,20PNR1GA,2021 NBA Playoffs - Round 1 - Home Game A,F,11395,18710,7315,16:37.3,2
5/22/2021,20PNR1GA,2021 NBA Playoffs - Round 1 - Home Game A,F,18710,535,-18175,46:20.1,3
5/22/2021,20PNR1GA,2021 NBA Playoffs - Round 1 - Home Game A,F,535,1100,565,52:05.3,4
5/22/2021,20PNR1GA,2021 NBA Playoffs - Round 1 - Home Game A,F,1100,720,-380,52:04.9,5
5/22/2021,20PNR1GA,2021 NBA Playoffs - Round 1 - Home Game A,F,720,900,180,52:05.9,6
5/22/2021,20PNR1GA,2021 NBA Playoffs - Round 1 - Home Game A,F,900,930,30,52:05.8,7
5/22/2021,20PNR1GA,2021 NBA Playoffs - Round 1 - Home Game A,F,930,740,-190,52:06.9,8
5/22/2021,20PNR1GA,2021 NBA Playoffs - Round 1 - Home Game A,F,740,1110,370,52:05.9,9
5/22/2021,20PNR1GA,2021 NBA Playoffs - Round 1 - Home Game A,F,1110,995,-115,52:05.8,10
5/22/2021,20PNR1GA,2021 NBA Playoffs - Round 1 - Home Game A,F,995,895,-100,52:09.2,11
5/22/2021,20PNR1GA,2021 NBA Playoffs - Round 1 - Home Game A,F,895,810,-85,52:06.1,12
5/22/2021,20PNR1GA,2021 NBA Playoffs - Round 1 - Home Game A,F,810,995,185,52:05.3,13
5/22/2021,20PNR1GA,2021 NBA Playoffs - Round 1 - Home Game A,F,995,850,-145,52:06.1,14
5/22/2021,20PNR1GA,2021 NBA Playoffs - Round 1 - Home Game A,F,850,320,-530,52:09.3,15
5/22/2021,20PNR1GA,2021 NBA Playoffs - Round 1 - Home Game A,G,0,10965,10965,32:40.9,1
5/22/2021,20PNR1GA,2021 NBA Playoffs - Round 1 - Home Game A,G,10965,17090,6125,16:37.4,2
5/22/2021,20PNR1GA,2021 NBA Playoffs - Round 1 - Home Game A,G,17090,490,-16600,46:20.2,3
5/22/2021,20PNR1GA,2021 NBA Playoffs - Round 1 - Home Game A,G,490,1100,610,52:05.3,4
5/22/2021,20PNR1GA,2021 NBA Playoffs - Round 1 - Home Game A,G,1100,1500,400,52:10.8,5
5/22/2021,20PNR1GA,2021 NBA Playoffs - Round 1 - Home Game A,G,1500,605,-895,52:04.9,6
5/22/2021,20PNR1GA,2021 NBA Playoffs - Round 1 - Home Game A,G,605,755,150,52:05.9,7
5/22/2021,20PNR1GA,2021 NBA Playoffs - Round 1 - Home Game A,G,755,775,20,52:05.8,8
5/22/2021,20PNR1GA,2021 NBA Playoffs - Round 1 - Home Game A,G,775,675,-100,52:06.9,9
5/22/2021,20PNR1GA,2021 NBA Playoffs - Round 1 - Home Game A,G,675,1020,345,52:05.9,10
5/22/2021,20PNR1GA,2021 NBA Playoffs - Round 1 - Home Game A,G,1020,920,-100,52:05.8,11
5/22/2021,20PNR1GA,2021 NBA Playoffs - Round 1 - Home Game A,G,920,825,-95,52:09.2,12
5/22/2021,20PNR1GA,2021 NBA Playoffs - Round 1 - Home Game A,G,825,740,-85,52:06.1,13
5/22/2021,20PNR1GA,2021 NBA Playoffs - Round 1 - Home Game A,G,740,920,180,52:05.3,14
5/22/2021,20PNR1GA,2021 NBA Playoffs - Round 1 - Home Game A,G,920,750,-170,52:05.9,15
5/22/2021,20PNR1GA,2021 NBA Playoffs - Round 1 - Home Game A,G,750,295,-455,52:09.3,16
5/22/2021,20PNR1GA,2021 NBA Playoffs - Round 1 - Home Game A,H,0,10535,10535,32:41.0,1
5/22/2021,20PNR1GA,2021 NBA Playoffs - Round 1 - Home Game A,H,10535,15770,5235,16:37.5,2
5/22/2021,20PNR1GA,2021 NBA Playoffs - Round 1 - Home Game A,H,15770,450,-15320,46:20.3,3
5/22/2021,20PNR1GA,2021 NBA Playoffs - Round 1 - Home Game A,H,450,1100,650,52:05.3,4
5/22/2021,20PNR1GA,2021 NBA Playoffs - Round 1 - Home Game A,H,1100,1500,400,52:10.8,5
5/22/2021,20PNR1GA,2021 NBA Playoffs - Round 1 - Home Game A,H,1500,575,-925,52:04.9,6
5/22/2021,20PNR1GA,2021 NBA Playoffs - Round 1 - Home Game A,H,575,720,145,52:05.9,7
5/22/2021,20PNR1GA,2021 NBA Playoffs - Round 1 - Home Game A,H,720,740,20,52:05.8,8
5/22/2021,20PNR1GA,2021 NBA Playoffs - Round 1 - Home Game A,H,740,625,-115,52:06.9,9
5/22/2021,20PNR1GA,2021 NBA Playoffs - Round 1 - Home Game A,H,625,940,315,52:05.9,10
5/22/2021,20PNR1GA,2021 NBA Playoffs - Round 1 - Home Game A,H,940,850,-90,52:05.8,11
5/22/2021,20PNR1GA,2021 NBA Playoffs - Round 1 - Home Game A,H,850,765,-85,52:09.2,12
5/22/2021,20PNR1GA,2021 NBA Playoffs - Round 1 - Home Game A,H,765,685,-80,52:06.1,13
5/22/2021,20PNR1GA,2021 NBA Playoffs - Round 1 - Home Game A,H,685,850,165,52:05.3,14
5/22/2021,20PNR1GA,2021 NBA Playoffs - Round 1 - Home Game A,H,850,700,-150,52:05.9,15
5/22/2021,20PNR1GA,2021 NBA Playoffs - Round 1 - Home Game A,H,700,270,-430,52:09.3,16
5/22/2021,20PNR1GA,2021 NBA Playoffs - Round 1 - Home Game A,I,0,9030,9030,32:41.1,1
5/22/2021,20PNR1GA,2021 NBA Playoffs - Round 1 - Home Game A,I,9030,14180,5150,16:37.6,2
5/22/2021,20PNR1GA,2021 NBA Playoffs - Round 1 - Home Game A,I,14180,405,-13775,46:20.4,3
5/22/2021,20PNR1GA,2021 NBA Playoffs - Round 1 - Home Game A,I,405,1100,695,52:05.3,4
5/22/2021,20PNR1GA,2021 NBA Playoffs - Round 1 - Home Game A,I,1100,525,-575,52:04.9,5
5/22/2021,20PNR1GA,2021 NBA Playoffs - Round 1 - Home Game A,I,525,655,130,52:05.9,6
5/22/2021,20PNR1GA,2021 NBA Playoffs - Round 1 - Home Game A,I,655,675,20,52:05.8,7
5/22/2021,20PNR1GA,2021 NBA Playoffs - Round 1 - Home Game A,I,675,565,-110,52:06.9,8
5/22/2021,20PNR1GA,2021 NBA Playoffs - Round 1 - Home Game A,I,565,850,285,52:05.9,9
5/22/2021,20PNR1GA,2021 NBA Playoffs - Round 1 - Home Game A,I,850,755,-95,52:05.8,10
5/22/2021,20PNR1GA,2021 NBA Playoffs - Round 1 - Home Game A,I,755,680,-75,52:09.2,11
5/22/2021,20PNR1GA,2021 NBA Playoffs - Round 1 - Home Game A,I,680,610,-70,52:06.1,12
5/22/2021,20PNR1GA,2021 NBA Playoffs - Round 1 - Home Game A,I,610,755,145,52:05.3,13
5/22/2021,20PNR1GA,2021 NBA Playoffs - Round 1 - Home Game A,I,755,650,-105,52:05.9,14
5/22/2021,20PNR1GA,2021 NBA Playoffs - Round 1 - Home Game A,I,650,250,-400,52:09.3,15
5/22/2021,20PNR1GA,2021 NBA Playoffs - Round 1 - Home Game A,J,0,8385,8385,32:41.2,1
5/22/2021,20PNR1GA,2021 NBA Playoffs - Round 1 - Home Game A,J,8385,13080,4695,16:37.7,2
5/22/2021,20PNR1GA,2021 NBA Playoffs - Round 1 - Home Game A,J,13080,375,-12705,46:20.4,3
5/22/2021,20PNR1GA,2021 NBA Playoffs - Round 1 - Home Game A,J,375,1100,725,52:05.3,4
5/22/2021,20PNR1GA,2021 NBA Playoffs - Round 1 - Home Game A,J,1100,485,-615,52:04.9,5
5/22/2021,20PNR1GA,2021 NBA Playoffs - Round 1 - Home Game A,J,485,605,120,52:05.9,6
5/22/2021,20PNR1GA,2021 NBA Playoffs - Round 1 - Home Game A,J,605,625,20,52:05.8,7
5/22/2021,20PNR1GA,2021 NBA Playoffs - Round 1 - Home Game A,J,625,520,-105,52:06.9,8
5/22/2021,20PNR1GA,2021 NBA Playoffs - Round 1 - Home Game A,J,520,780,260,52:05.9,9
5/22/2021,20PNR1GA,2021 NBA Playoffs - Round 1 - Home Game A,J,780,700,-80,52:05.8,10
5/22/2021,20PNR1GA,2021 NBA Playoffs - Round 1 - Home Game A,J,700,630,-70,52:09.2,11
5/22/2021,20PNR1GA,2021 NBA Playoffs - Round 1 - Home Game A,J,630,560,-70,52:06.1,12
5/22/2021,20PNR1GA,2021 NBA Playoffs - Round 1 - Home Game A,J,560,700,140,52:05.3,13
5/22/2021,20PNR1GA,2021 NBA Playoffs - Round 1 - Home Game A,J,700,600,-100,52:05.9,14
5/22/2021,20PNR1GA,2021 NBA Playoffs - Round 1 - Home Game A,J,600,235,-365,52:09.3,15
5/22/2021,20PNR1GA,2021 NBA Playoffs - Round 1 - Home Game A,K,0,6880,6880,32:41.3,1
5/22/2021,20PNR1GA,2021 NBA Playoffs - Round 1 - Home Game A,K,6880,12160,5280,16:37.8,2
5/22/2021,20PNR1GA,2021 NBA Playoffs - Round 1 - Home Game A,K,12160,350,-11810,46:20.5,3
5/22/2021,20PNR1GA,2021 NBA Playoffs - Round 1 - Home Game A,K,350,1100,750,52:05.3,4
5/22/2021,20PNR1GA,2021 NBA Playoffs - Round 1 - Home Game A,K,1100,435,-665,52:04.9,5
5/22/2021,20PNR1GA,2021 NBA Playoffs - Round 1 - Home Game A,K,435,545,110,52:05.9,6
5/22/2021,20PNR1GA,2021 NBA Playoffs - Round 1 - Home Game A,K,545,565,20,52:05.8,7
5/22/2021,20PNR1GA,2021 NBA Playoffs - Round 1 - Home Game A,K,565,485,-80,52:06.9,8
5/22/2021,20PNR1GA,2021 NBA Playoffs - Round 1 - Home Game A,K,485,730,245,52:05.9,9
5/22/2021,20PNR1GA,2021 NBA Playoffs - Round 1 - Home Game A,K,730,660,-70,52:05.8,10
5/22/2021,20PNR1GA,2021 NBA Playoffs - Round 1 - Home Game A,K,660,595,-65,52:09.2,11
5/22/2021,20PNR1GA,2021 NBA Playoffs - Round 1 - Home Game A,K,595,535,-60,52:06.1,12
5/22/2021,20PNR1GA,2021 NBA Playoffs - Round 1 - Home Game A,K,535,660,125,52:05.3,13
5/22/2021,20PNR1GA,2021 NBA Playoffs - Round 1 - Home Game A,K,660,560,-100,52:05.9,14
5/22/2021,20PNR1GA,2021 NBA Playoffs - Round 1 - Home Game A,K,560,220,-340,52:09.3,15
5/22/2021,20PNR1GA,2021 NBA Playoffs - Round 1 - Home Game A,L,0,6450,6450,32:41.4,1
5/22/2021,20PNR1GA,2021 NBA Playoffs - Round 1 - Home Game A,L,6450,11930,5480,16:37.9,2
5/22/2021,20PNR1GA,2021 NBA Playoffs - Round 1 - Home Game A,L,11930,340,-11590,46:20.6,3
5/22/2021,20PNR1GA,2021 NBA Playoffs - Round 1 - Home Game A,L,340,1100,760,52:05.3,4
5/22/2021,20PNR1GA,2021 NBA Playoffs - Round 1 - Home Game A,L,1100,400,-700,52:04.9,5
5/22/2021,20PNR1GA,2021 NBA Playoffs - Round 1 - Home Game A,L,400,500,100,52:05.9,6
5/22/2021,20PNR1GA,2021 NBA Playoffs - Round 1 - Home Game A,L,500,520,20,52:05.8,7
5/22/2021,20PNR1GA,2021 NBA Playoffs - Round 1 - Home Game A,L,520,475,-45,52:06.9,8
5/22/2021,20PNR1GA,2021 NBA Playoffs - Round 1 - Home Game A,L,475,715,240,52:05.9,9
5/22/2021,20PNR1GA,2021 NBA Playoffs - Round 1 - Home Game A,L,715,645,-70,52:05.8,10
5/22/2021,20PNR1GA,2021 NBA Playoffs - Round 1 - Home Game A,L,645,580,-65,52:09.2,11
5/22/2021,20PNR1GA,2021 NBA Playoffs - Round 1 - Home Game A,L,580,520,-60,52:06.1,12
5/22/2021,20PNR1GA,2021 NBA Playoffs - Round 1 - Home Game A,L,520,645,125,52:05.3,13
5/22/2021,20PNR1GA,2021 NBA Playoffs - Round 1 - Home Game A,L,645,540,-105,52:05.9,14
5/22/2021,20PNR1GA,2021 NBA Playoffs - Round 1 - Home Game A,L,540,215,-325,52:09.3,15
5/22/2021,20PNR1GA,2021 NBA Playoffs - Round 1 - Home Game A,M,0,6020,6020,32:41.5,1
5/22/2021,20PNR1GA,2021 NBA Playoffs - Round 1 - Home Game A,M,6020,10470,4450,16:38.0,2
5/22/2021,20PNR1GA,2021 NBA Playoffs - Round 1 - Home Game A,M,10470,300,-10170,46:20.7,3
5/22/2021,20PNR1GA,2021 NBA Playoffs - Round 1 - Home Game A,M,300,1100,800,52:05.3,4
5/22/2021,20PNR1GA,2021 NBA Playoffs - Round 1 - Home Game A,M,1100,370,-730,52:04.9,5
5/22/2021,20PNR1GA,2021 NBA Playoffs - Round 1 - Home Game A,M,370,465,95,52:05.9,6
5/22/2021,20PNR1GA,2021 NBA Playoffs - Round 1 - Home Game A,M,465,485,20,52:05.8,7
5/22/2021,20PNR1GA,2021 NBA Playoffs - Round 1 - Home Game A,M,485,420,-65,52:06.9,8
5/22/2021,20PNR1GA,2021 NBA Playoffs - Round 1 - Home Game A,M,420,630,210,52:05.9,9
5/22/2021,20PNR1GA,2021 NBA Playoffs - Round 1 - Home Game A,M,630,565,-65,52:05.8,10
5/22/2021,20PNR1GA,2021 NBA Playoffs - Round 1 - Home Game A,M,565,510,-55,52:09.2,11
5/22/2021,20PNR1GA,2021 NBA Playoffs - Round 1 - Home Game A,M,510,455,-55,52:06.1,12
5/22/2021,20PNR1GA,2021 NBA Playoffs - Round 1 - Home Game A,M,455,565,110,52:05.3,13
5/22/2021,20PNR1GA,2021 NBA Playoffs - Round 1 - Home Game A,M,565,440,-125,52:05.9,14
5/22/2021,20PNR1GA,2021 NBA Playoffs - Round 1 - Home Game A,M,440,190,-250,52:09.3,15
5/22/2021,20PNR1GA,2021 NBA Playoffs - Round 1 - Home Game A,N,0,10105,10105,32:41.6,1
5/22/2021,20PNR1GA,2021 NBA Playoffs - Round 1 - Home Game A,N,10105,17290,7185,16:38.1,2
5/22/2021,20PNR1GA,2021 NBA Playoffs - Round 1 - Home Game A,N,17290,495,-16795,46:20.7,3
5/22/2021,20PNR1GA,2021 NBA Playoffs - Round 1 - Home Game A,N,495,1100,605,52:05.3,4
5/22/2021,20PNR1GA,2021 NBA Playoffs - Round 1 - Home Game A,N,1100,365,-735,52:04.9,5
5/22/2021,20PNR1GA,2021 NBA Playoffs - Round 1 - Home Game A,N,365,455,90,52:05.9,6
5/22/2021,20PNR1GA,2021 NBA Playoffs - Round 1 - Home Game A,N,455,475,20,52:05.8,7
5/22/2021,20PNR1GA,2021 NBA Playoffs - Round 1 - Home Game A,N,475,685,210,52:06.9,8
5/22/2021,20PNR1GA,2021 NBA Playoffs - Round 1 - Home Game A,N,685,1030,345,52:05.9,9
5/22/2021,20PNR1GA,2021 NBA Playoffs - Round 1 - Home Game A,N,1030,925,-105,52:05.8,10
5/22/2021,20PNR1GA,2021 NBA Playoffs - Round 1 - Home Game A,N,925,830,-95,52:09.2,11
5/22/2021,20PNR1GA,2021 NBA Playoffs - Round 1 - Home Game A,N,830,745,-85,52:06.1,12
5/22/2021,20PNR1GA,2021 NBA Playoffs - Round 1 - Home Game A,N,745,925,180,52:05.3,13
5/22/2021,20PNR1GA,2021 NBA Playoffs - Round 1 - Home Game A,N,925,815,-110,52:05.9,14
5/22/2021,20PNR1GA,2021 NBA Playoffs - Round 1 - Home Game A,N,815,310,-505,52:09.3,15
5/22/2021,20PNR1GA,2021 NBA Playoffs - Round 1 - Home Game A,O,0,9460,9460,32:41.7,1
5/22/2021,20PNR1GA,2021 NBA Playoffs - Round 1 - Home Game A,O,9460,15550,6090,16:38.1,2
5/22/2021,20PNR1GA,2021 NBA Playoffs - Round 1 - Home Game A,O,15550,445,-15105,46:20.8,3
5/22/2021,20PNR1GA,2021 NBA Playoffs - Round 1 - Home Game A,O,445,1100,655,52:05.3,4
5/22/2021,20PNR1GA,2021 NBA Playoffs - Round 1 - Home Game A,O,1100,320,-780,52:04.9,5
5/22/2021,20PNR1GA,2021 NBA Playoffs - Round 1 - Home Game A,O,320,400,80,52:05.9,6
5/22/2021,20PNR1GA,2021 NBA Playoffs - Round 1 - Home Game A,O,400,420,20,52:05.8,7
5/22/2021,20PNR1GA,2021 NBA Playoffs - Round 1 - Home Game A,O,420,615,195,52:06.9,8
5/22/2021,20PNR1GA,2021 NBA Playoffs - Round 1 - Home Game A,O,615,925,310,52:05.9,9
5/22/2021,20PNR1GA,2021 NBA Playoffs - Round 1 - Home Game A,O,925,835,-90,52:05.8,10
5/22/2021,20PNR1GA,2021 NBA Playoffs - Round 1 - Home Game A,O,835,750,-85,52:09.2,11
5/22/2021,20PNR1GA,2021 NBA Playoffs - Round 1 - Home Game A,O,750,675,-75,52:06.1,12
5/22/2021,20PNR1GA,2021 NBA Playoffs - Round 1 - Home Game A,O,675,835,160,52:05.3,13
5/22/2021,20PNR1GA,2021 NBA Playoffs - Round 1 - Home Game A,O,835,725,-110,52:05.9,14
5/22/2021,20PNR1GA,2021 NBA Playoffs - Round 1 - Home Game A,O,725,275,-450,52:09.3,15
5/22/2021,20PNR1GA,2021 NBA Playoffs - Round 1 - Home Game A,P,0,7740,7740,32:41.8,1
5/22/2021,20PNR1GA,2021 NBA Playoffs - Round 1 - Home Game A,P,7740,13670,5930,16:38.2,2
5/22/2021,20PNR1GA,2021 NBA Playoffs - Round 1 - Home Game A,P,13670,390,-13280,46:20.9,3
5/22/2021,20PNR1GA,2021 NBA Playoffs - Round 1 - Home Game A,P,390,1100,710,52:05.3,4
5/22/2021,20PNR1GA,2021 NBA Playoffs - Round 1 - Home Game A,P,1100,1500,400,52:10.8,5
5/22/2021,20PNR1GA,2021 NBA Playoffs - Round 1 - Home Game A,P,1500,530,-970,52:04.9,6
5/22/2021,20PNR1GA,2021 NBA Playoffs - Round 1 - Home Game A,P,530,665,135,52:05.9,7
5/22/2021,20PNR1GA,2021 NBA Playoffs - Round 1 - Home Game A,P,665,685,20,52:05.8,8
5/22/2021,20PNR1GA,2021 NBA Playoffs - Round 1 - Home Game A,P,685,545,-140,52:06.9,9
5/22/2021,20PNR1GA,2021 NBA Playoffs - Round 1 - Home Game A,P,545,820,275,52:05.9,10
5/22/2021,20PNR1GA,2021 NBA Playoffs - Round 1 - Home Game A,P,820,740,-80,52:05.8,11
5/22/2021,20PNR1GA,2021 NBA Playoffs - Round 1 - Home Game A,P,740,665,-75,52:09.2,12
5/22/2021,20PNR1GA,2021 NBA Playoffs - Round 1 - Home Game A,P,665,590,-75,52:06.1,13
5/22/2021,20PNR1GA,2021 NBA Playoffs - Round 1 - Home Game A,P,590,740,150,52:05.3,14
5/22/2021,20PNR1GA,2021 NBA Playoffs - Round 1 - Home Game A,P,740,635,-105,52:05.9,15
5/22/2021,20PNR1GA,2021 NBA Playoffs - Round 1 - Home Game A,P,635,245,-390,52:09.3,16
5/22/2021,20PNR1GA,2021 NBA Playoffs - Round 1 - Home Game A,Q,0,6880,6880,32:41.9,1
5/22/2021,20PNR1GA,2021 NBA Playoffs - Round 1 - Home Game A,Q,6880,10960,4080,16:38.3,2
5/22/2021,20PNR1GA,2021 NBA Playoffs - Round 1 - Home Game A,Q,10960,315,-10645,46:21.0,3
5/22/2021,20PNR1GA,2021 NBA Playoffs - Round 1 - Home Game A,Q,315,1100,785,52:05.3,4
5/22/2021,20PNR1GA,2021 NBA Playoffs - Round 1 - Home Game A,Q,1100,475,-625,52:04.9,5
5/22/2021,20PNR1GA,2021 NBA Playoffs - Round 1 - Home Game A,Q,475,595,120,52:05.9,6
5/22/2021,20PNR1GA,2021 NBA Playoffs - Round 1 - Home Game A,Q,595,615,20,52:05.8,7
5/22/2021,20PNR1GA,2021 NBA Playoffs - Round 1 - Home Game A,Q,615,440,-175,52:06.9,8
5/22/2021,20PNR1GA,2021 NBA Playoffs - Round 1 - Home Game A,Q,440,660,220,52:05.9,9
5/22/2021,20PNR1GA,2021 NBA Playoffs - Round 1 - Home Game A,Q,660,595,-65,52:05.8,10
5/22/2021,20PNR1GA,2021 NBA Playoffs - Round 1 - Home Game A,Q,595,535,-60,52:09.2,11
5/22/2021,20PNR1GA,2021 NBA Playoffs - Round 1 - Home Game A,Q,535,480,-55,52:06.1,12
5/22/2021,20PNR1GA,2021 NBA Playoffs - Round 1 - Home Game A,Q,480,595,115,52:05.3,13
5/22/2021,20PNR1GA,2021 NBA Playoffs - Round 1 - Home Game A,Q,595,495,-100,52:05.9,14
5/22/2021,20PNR1GA,2021 NBA Playoffs - Round 1 - Home Game A,Q,495,200,-295,52:09.3,15
5/22/2021,20PNR1GA,2021 NBA Playoffs - Round 1 - Home Game A,R,0,5590,5590,32:42.0,1
5/22/2021,20PNR1GA,2021 NBA Playoffs - Round 1 - Home Game A,R,5590,9740,4150,16:38.4,2
5/22/2021,20PNR1GA,2021 NBA Playoffs - Round 1 - Home Game A,R,9740,280,-9460,46:21.0,3
5/22/2021,20PNR1GA,2021 NBA Playoffs - Round 1 - Home Game A,R,280,1100,820,52:05.3,4
5/22/2021,20PNR1GA,2021 NBA Playoffs - Round 1 - Home Game A,R,1100,420,-680,52:04.9,5
5/22/2021,20PNR1GA,2021 NBA Playoffs - Round 1 - Home Game A,R,420,525,105,52:05.9,6
5/22/2021,20PNR1GA,2021 NBA Playoffs - Round 1 - Home Game A,R,525,545,20,52:05.8,7
5/22/2021,20PNR1GA,2021 NBA Playoffs - Round 1 - Home Game A,R,545,400,-145,52:06.9,8
5/22/2021,20PNR1GA,2021 NBA Playoffs - Round 1 - Home Game A,R,400,600,200,52:05.9,9
5/22/2021,20PNR1GA,2021 NBA Playoffs - Round 1 - Home Game A,R,600,540,-60,52:05.8,10
5/22/2021,20PNR1GA,2021 NBA Playoffs - Round 1 - Home Game A,R,540,485,-55,52:09.2,11
5/22/2021,20PNR1GA,2021 NBA Playoffs - Round 1 - Home Game A,R,485,435,-50,52:06.1,12
5/22/2021,20PNR1GA,2021 NBA Playoffs - Round 1 - Home Game A,R,435,540,105,52:05.3,13
5/22/2021,20PNR1GA,2021 NBA Playoffs - Round 1 - Home Game A,R,540,445,-95,52:05.9,14
5/22/2021,20PNR1GA,2021 NBA Playoffs - Round 1 - Home Game A,R,445,185,-260,52:09.3,15
5/22/2021,20PNR1GA,2021 NBA Playoffs - Round 1 - Home Game A,S,0,5590,5590,32:42.1,1
5/22/2021,20PNR1GA,2021 NBA Playoffs - Round 1 - Home Game A,S,5590,9740,4150,16:38.5,2
5/22/2021,20PNR1GA,2021 NBA Playoffs - Round 1 - Home Game A,S,9740,280,-9460,46:21.1,3
5/22/2021,20PNR1GA,2021 NBA Playoffs - Round 1 - Home Game A,S,280,1100,820,52:05.3,4
5/22/2021,20PNR1GA,2021 NBA Playoffs - Round 1 - Home Game A,S,1100,335,-765,52:04.9,5
5/22/2021,20PNR1GA,2021 NBA Playoffs - Round 1 - Home Game A,S,335,420,85,52:05.9,6
5/22/2021,20PNR1GA,2021 NBA Playoffs - Round 1 - Home Game A,S,420,440,20,52:05.8,7
5/22/2021,20PNR1GA,2021 NBA Playoffs - Round 1 - Home Game A,S,440,400,-40,52:06.9,8
5/22/2021,20PNR1GA,2021 NBA Playoffs - Round 1 - Home Game A,S,400,600,200,52:05.9,9
5/22/2021,20PNR1GA,2021 NBA Playoffs - Round 1 - Home Game A,S,600,540,-60,52:05.8,10
5/22/2021,20PNR1GA,2021 NBA Playoffs - Round 1 - Home Game A,S,540,485,-55,52:09.2,11
5/22/2021,20PNR1GA,2021 NBA Playoffs - Round 1 - Home Game A,S,485,435,-50,52:06.1,12
5/22/2021,20PNR1GA,2021 NBA Playoffs - Round 1 - Home Game A,S,435,540,105,52:05.3,13
5/22/2021,20PNR1GA,2021 NBA Playoffs - Round 1 - Home Game A,S,540,445,-95,52:05.9,14
5/22/2021,20PNR1GA,2021 NBA Playoffs - Round 1 - Home Game A,S,445,185,-260,52:09.3,15
5/22/2021,20PNR1GA,2021 NBA Playoffs - Round 1 - Home Game A,T,0,4730,4730,32:42.2,1
5/22/2021,20PNR1GA,2021 NBA Playoffs - Round 1 - Home Game A,T,4730,8030,3300,16:38.6,2
5/22/2021,20PNR1GA,2021 NBA Playoffs - Round 1 - Home Game A,T,8030,230,-7800,46:21.2,3
5/22/2021,20PNR1GA,2021 NBA Playoffs - Round 1 - Home Game A,T,230,1100,870,52:05.3,4
5/22/2021,20PNR1GA,2021 NBA Playoffs - Round 1 - Home Game A,T,1100,300,-800,52:04.9,5
5/22/2021,20PNR1GA,2021 NBA Playoffs - Round 1 - Home Game A,T,300,375,75,52:05.9,6
5/22/2021,20PNR1GA,2021 NBA Playoffs - Round 1 - Home Game A,T,375,400,25,52:05.8,7
5/22/2021,20PNR1GA,2021 NBA Playoffs - Round 1 - Home Game A,T,400,320,-80,52:06.9,8
5/22/2021,20PNR1GA,2021 NBA Playoffs - Round 1 - Home Game A,T,320,480,160,52:05.9,9
5/22/2021,20PNR1GA,2021 NBA Playoffs - Round 1 - Home Game A,T,480,435,-45,52:05.8,10
5/22/2021,20PNR1GA,2021 NBA Playoffs - Round 1 - Home Game A,T,435,390,-45,52:09.2,11
5/22/2021,20PNR1GA,2021 NBA Playoffs - Round 1 - Home Game A,T,390,350,-40,52:06.1,12
5/22/2021,20PNR1GA,2021 NBA Playoffs - Round 1 - Home Game A,T,350,435,85,52:05.3,13
5/22/2021,20PNR1GA,2021 NBA Playoffs - Round 1 - Home Game A,T,435,345,-90,52:05.9,14
5/22/2021,20PNR1GA,2021 NBA Playoffs - Round 1 - Home Game A,T,345,170,-175,52:09.3,15
5/22/2021,20PNR1GA,2021 NBA Playoffs - Round 1 - Home Game A,U,0,3870,3870,32:42.3,1
5/22/2021,20PNR1GA,2021 NBA Playoffs - Round 1 - Home Game A,U,3870,7130,3260,16:38.7,2
5/22/2021,20PNR1GA,2021 NBA Playoffs - Round 1 - Home Game A,U,7130,205,-6925,46:21.2,3
5/22/2021,20PNR1GA,2021 NBA Playoffs - Round 1 - Home Game A,U,205,1100,895,52:05.3,4
5/22/2021,20PNR1GA,2021 NBA Playoffs - Round 1 - Home Game A,U,1100,300,-800,52:04.9,5
5/22/2021,20PNR1GA,2021 NBA Playoffs - Round 1 - Home Game A,U,300,375,75,52:05.9,6
5/22/2021,20PNR1GA,2021 NBA Playoffs - Round 1 - Home Game A,U,375,400,25,52:05.8,7
5/22/2021,20PNR1GA,2021 NBA Playoffs - Round 1 - Home Game A,U,400,295,-105,52:06.9,8
5/22/2021,20PNR1GA,2021 NBA Playoffs - Round 1 - Home Game A,U,295,445,150,52:05.9,9
5/22/2021,20PNR1GA,2021 NBA Playoffs - Round 1 - Home Game A,U,445,400,-45,52:05.8,10
5/22/2021,20PNR1GA,2021 NBA Playoffs - Round 1 - Home Game A,U,400,360,-40,52:09.2,11
5/22/2021,20PNR1GA,2021 NBA Playoffs - Round 1 - Home Game A,U,360,320,-40,52:06.1,12
5/22/2021,20PNR1GA,2021 NBA Playoffs - Round 1 - Home Game A,U,320,160,-160,52:05.3,13
5/22/2021,20PNR1GA,2021 NBA Playoffs - Round 1 - Home Game A,U,160,175,15,52:11.9,14
5/22/2021,20PNR1GA,2021 NBA Playoffs - Round 1 - Home Game A,U,175,135,-40,52:06.1,15
5/22/2021,20PNR1GA,2021 NBA Playoffs - Round 1 - Home Game A,U,135,145,10,52:06.2,16
5/22/2021,20PNR1GA,2021 NBA Playoffs - Round 1 - Home Game A,U,145,165,20,52:06.3,17
5/22/2021,20PNR1GA,2021 NBA Playoffs - Round 1 - Home Game A,V,0,3440,3440,32:42.4,1
5/22/2021,20PNR1GA,2021 NBA Playoffs - Round 1 - Home Game A,V,3440,6430,2990,16:38.8,2
5/22/2021,20PNR1GA,2021 NBA Playoffs - Round 1 - Home Game A,V,6430,185,-6245,46:21.3,3
5/22/2021,20PNR1GA,2021 NBA Playoffs - Round 1 - Home Game A,V,185,1100,915,52:05.3,4
5/22/2021,20PNR1GA,2021 NBA Playoffs - Round 1 - Home Game A,V,1100,245,-855,52:04.9,5
5/22/2021,20PNR1GA,2021 NBA Playoffs - Round 1 - Home Game A,V,245,305,60,52:05.9,6
5/22/2021,20PNR1GA,2021 NBA Playoffs - Round 1 - Home Game A,V,305,320,15,52:05.8,7
5/22/2021,20PNR1GA,2021 NBA Playoffs - Round 1 - Home Game A,V,320,250,-70,52:06.9,8
5/22/2021,20PNR1GA,2021 NBA Playoffs - Round 1 - Home Game A,V,250,375,125,52:05.9,9
5/22/2021,20PNR1GA,2021 NBA Playoffs - Round 1 - Home Game A,V,375,345,-30,52:05.8,10
5/22/2021,20PNR1GA,2021 NBA Playoffs - Round 1 - Home Game A,V,345,310,-35,52:09.2,11
5/22/2021,20PNR1GA,2021 NBA Playoffs - Round 1 - Home Game A,V,310,275,-35,52:06.1,12
5/22/2021,20PNR1GA,2021 NBA Playoffs - Round 1 - Home Game A,V,275,145,-130,52:05.3,13
5/22/2021,20PNR1GA,2021 NBA Playoffs - Round 1 - Home Game A,V,145,155,10,52:11.9,14
5/22/2021,20PNR1GA,2021 NBA Playoffs - Round 1 - Home Game A,V,155,120,-35,52:06.1,15
5/22/2021,20PNR1GA,2021 NBA Playoffs - Round 1 - Home Game A,V,120,130,10,52:06.2,16
5/22/2021,20PNR1GA,2021 NBA Playoffs - Round 1 - Home Game A,V,130,140,10,52:06.3,17
5/22/2021,20PNR1GA,2021 NBA Playoffs - Round 1 - Home Game A,W,0,3010,3010,32:42.5,1
5/22/2021,20PNR1GA,2021 NBA Playoffs - Round 1 - Home Game A,W,3010,6030,3020,16:38.8,2
5/22/2021,20PNR1GA,2021 NBA Playoffs - Round 1 - Home Game A,W,6030,175,-5855,46:21.4,3
5/22/2021,20PNR1GA,2021 NBA Playoffs - Round 1 - Home Game A,W,175,1100,925,52:05.3,4
5/22/2021,20PNR1GA,2021 NBA Playoffs - Round 1 - Home Game A,W,1100,220,-880,52:04.9,5
5/22/2021,20PNR1GA,2021 NBA Playoffs - Round 1 - Home Game A,W,220,275,55,52:05.9,6
5/22/2021,20PNR1GA,2021 NBA Playoffs - Round 1 - Home Game A,W,275,295,20,52:05.8,7
5/22/2021,20PNR1GA,2021 NBA Playoffs - Round 1 - Home Game A,W,295,245,-50,52:06.9,8
5/22/2021,20PNR1GA,2021 NBA Playoffs - Round 1 - Home Game A,W,245,370,125,52:05.9,9
5/22/2021,20PNR1GA,2021 NBA Playoffs - Round 1 - Home Game A,W,370,335,-35,52:05.8,10
5/22/2021,20PNR1GA,2021 NBA Playoffs - Round 1 - Home Game A,W,335,299,-36,52:09.2,11
5/22/2021,20PNR1GA,2021 NBA Playoffs - Round 1 - Home Game A,W,299,269,-30,52:06.1,12
5/22/2021,20PNR1GA,2021 NBA Playoffs - Round 1 - Home Game A,W,269,135,-134,52:05.3,13
5/22/2021,20PNR1GA,2021 NBA Playoffs - Round 1 - Home Game A,W,135,145,10,52:11.9,14
5/22/2021,20PNR1GA,2021 NBA Playoffs - Round 1 - Home Game A,W,145,110,-35,52:06.1,15
5/22/2021,20PNR1GA,2021 NBA Playoffs - Round 1 - Home Game A,W,110,120,10,52:06.2,16
5/22/2021,20PNR1GA,2021 NBA Playoffs - Round 1 - Home Game A,W,120,130,10,52:06.3,17
5/22/2021,20PNR1GA,2021 NBA Playoffs - Round 1 - Home Game A,X,0,2795,2795,32:42.6,1
5/22/2021,20PNR1GA,2021 NBA Playoffs - Round 1 - Home Game A,X,2795,5370,2575,16:38.9,2
5/22/2021,20PNR1GA,2021 NBA Playoffs - Round 1 - Home Game A,X,5370,155,-5215,46:21.5,3
5/22/2021,20PNR1GA,2021 NBA Playoffs - Round 1 - Home Game A,X,155,1100,945,52:05.3,4
5/22/2021,20PNR1GA,2021 NBA Playoffs - Round 1 - Home Game A,X,1100,620,-480,52:04.9,5
5/22/2021,20PNR1GA,2021 NBA Playoffs - Round 1 - Home Game A,X,620,775,155,52:05.9,6
5/22/2021,20PNR1GA,2021 NBA Playoffs - Round 1 - Home Game A,X,775,220,-555,52:06.9,7
5/22/2021,20PNR1GA,2021 NBA Playoffs - Round 1 - Home Game A,X,220,330,110,52:05.9,8
5/22/2021,20PNR1GA,2021 NBA Playoffs - Round 1 - Home Game A,X,330,300,-30,52:05.8,9
5/22/2021,20PNR1GA,2021 NBA Playoffs - Round 1 - Home Game A,X,300,270,-30,52:09.2,10
5/22/2021,20PNR1GA,2021 NBA Playoffs - Round 1 - Home Game A,X,270,245,-25,52:06.1,11
5/22/2021,20PNR1GA,2021 NBA Playoffs - Round 1 - Home Game A,X,245,125,-120,52:05.3,12
5/22/2021,20PNR1GA,2021 NBA Playoffs - Round 1 - Home Game A,X,125,135,10,52:11.9,13
5/22/2021,20PNR1GA,2021 NBA Playoffs - Round 1 - Home Game A,X,135,125,-10,52:18.8,14
5/22/2021,20PNR1GA,2021 NBA Playoffs - Round 1 - Home Game A,X,125,100,-25,52:06.1,15
5/22/2021,20PNR1GA,2021 NBA Playoffs - Round 1 - Home Game A,X,100,110,10,52:06.2,16
5/22/2021,20PNR1GA,2021 NBA Playoffs - Round 1 - Home Game A,X,110,120,10,52:06.3,17
5/22/2021,20PNR1GA,2021 NBA Playoffs - Round 1 - Home Game A,Y,0,2795,2795,32:42.7,1
5/22/2021,20PNR1GA,2021 NBA Playoffs - Round 1 - Home Game A,Y,2795,5220,2425,16:39.0,2
5/22/2021,20PNR1GA,2021 NBA Playoffs - Round 1 - Home Game A,Y,5220,150,-5070,46:21.5,3
5/22/2021,20PNR1GA,2021 NBA Playoffs - Round 1 - Home Game A,Y,150,1100,950,52:05.3,4
5/22/2021,20PNR1GA,2021 NBA Playoffs - Round 1 - Home Game A,Y,1100,215,-885,52:06.9,5
5/22/2021,20PNR1GA,2021 NBA Playoffs - Round 1 - Home Game A,Y,215,325,110,52:05.9,6
5/22/2021,20PNR1GA,2021 NBA Playoffs - Round 1 - Home Game A,Y,325,295,-30,52:05.8,7
5/22/2021,20PNR1GA,2021 NBA Playoffs - Round 1 - Home Game A,Y,295,265,-30,52:09.2,8
5/22/2021,20PNR1GA,2021 NBA Playoffs - Round 1 - Home Game A,Y,265,235,-30,52:06.1,9
5/22/2021,20PNR1GA,2021 NBA Playoffs - Round 1 - Home Game A,Y,235,120,-115,52:05.3,10
5/22/2021,20PNR1GA,2021 NBA Playoffs - Round 1 - Home Game A,Y,120,130,10,52:11.9,11
5/22/2021,20PNR1GA,2021 NBA Playoffs - Round 1 - Home Game A,Y,130,120,-10,52:18.8,12
5/22/2021,20PNR1GA,2021 NBA Playoffs - Round 1 - Home Game A,Y,120,95,-25,52:06.1,13
5/22/2021,20PNR1GA,2021 NBA Playoffs - Round 1 - Home Game A,Y,95,105,10,52:06.2,14
5/22/2021,20PNR1GA,2021 NBA Playoffs - Round 1 - Home Game A,Y,105,110,5,52:06.3,15
5/22/2021,20PNR1GA,2021 NBA Playoffs - Round 1 - Home Game A,Z,0,999999,999999,32:42.8,1
5/22/2021,20PNR1GA,2021 NBA Playoffs - Round 1 - Home Game A,Z,999999,20190,-979809,16:39.1,2
5/22/2021,20PNR1GA,2021 NBA Playoffs - Round 1 - Home Game A,Z,20190,580,-19610,46:21.6,3
5/22/2021,20PNR1GA,2021 NBA Playoffs - Round 1 - Home Game A,Z,580,1100,520,52:05.3,4
5/22/2021,20PNR1GA,2021 NBA Playoffs - Round 1 - Home Game A,Z,1100,775,-325,52:06.9,5
5/22/2021,20PNR1GA,2021 NBA Playoffs - Round 1 - Home Game A,Z,775,1170,395,52:05.9,6
5/22/2021,20PNR1GA,2021 NBA Playoffs - Round 1 - Home Game A,Z,1170,1050,-120,52:05.8,7
5/22/2021,20PNR1GA,2021 NBA Playoffs - Round 1 - Home Game A,Z,1050,945,-105,52:09.2,8
5/22/2021,20PNR1GA,2021 NBA Playoffs - Round 1 - Home Game A,Z,945,860,-85,52:06.1,9
5/22/2021,20PNR1GA,2021 NBA Playoffs - Round 1 - Home Game A,Z,860,1050,190,52:05.3,10
5/22/2021,20PNR1VA,2021 NBA Playoffs - Round 1 - Home Game A,1,0,6050,6050,09:53.4,1
5/22/2021,20PNR1VA,2021 NBA Playoffs - Round 1 - Home Game A,1,6050,1100,-4950,52:05.6,2
5/22/2021,20PNR1VA,2021 NBA Playoffs - Round 1 - Home Game A,1,1100,6000,4900,52:21.7,3
5/22/2021,20PNR1VA,2021 NBA Playoffs - Round 1 - Home Game A,1,6000,1100,-4900,52:07.2,4
5/22/2021,20PNR1VA,2021 NBA Playoffs - Round 1 - Home Game A,1,1100,6000,4900,52:06.1,5
5/22/2021,20PNR1VA,2021 NBA Playoffs - Round 1 - Home Game A,2,0,6050,6050,09:53.6,1
5/22/2021,20PNR1VA,2021 NBA Playoffs - Round 1 - Home Game A,2,6050,1100,-4950,52:05.6,2
5/22/2021,20PNR1VA,2021 NBA Playoffs - Round 1 - Home Game A,2,1100,6000,4900,52:21.7,3
5/22/2021,20PNR1VA,2021 NBA Playoffs - Round 1 - Home Game A,2,6000,1100,-4900,52:07.2,4
5/22/2021,20PNR1VA,2021 NBA Playoffs - Round 1 - Home Game A,2,1100,6000,4900,52:06.1,5
5/22/2021,20PNR1VA,2021 NBA Playoffs - Round 1 - Home Game A,3,0,6050,6050,09:53.7,1
5/22/2021,20PNR1VA,2021 NBA Playoffs - Round 1 - Home Game A,3,6050,1100,-4950,52:05.6,2
5/22/2021,20PNR1VA,2021 NBA Playoffs - Round 1 - Home Game A,3,1100,6000,4900,52:21.7,3
5/22/2021,20PNR1VA,2021 NBA Playoffs - Round 1 - Home Game A,3,6000,1100,-4900,52:07.2,4
5/22/2021,20PNR1VA,2021 NBA Playoffs - Round 1 - Home Game A,3,1100,6000,4900,52:06.1,5
5/22/2021,20PNR1VA,2021 NBA Playoffs - Round 1 - Home Game A,4,0,4400,4400,09:53.8,1
5/22/2021,20PNR1VA,2021 NBA Playoffs - Round 1 - Home Game A,4,4400,1100,-3300,52:05.6,2
5/22/2021,20PNR1VA,2021 NBA Playoffs - Round 1 - Home Game A,4,1100,6000,4900,52:21.7,3
5/22/2021,20PNR1VA,2021 NBA Playoffs - Round 1 - Home Game A,4,6000,1100,-4900,52:07.2,4
5/22/2021,20PNR1VA,2021 NBA Playoffs - Round 1 - Home Game A,4,1100,6000,4900,52:06.1,5
5/22/2021,20PNR1VA,2021 NBA Playoffs - Round 1 - Home Game A,5,0,1820,1820,09:53.9,1
5/22/2021,20PNR1VA,2021 NBA Playoffs - Round 1 - Home Game A,5,1820,1100,-720,52:05.6,2
5/22/2021,20PNR1VA,2021 NBA Playoffs - Round 1 - Home Game A,5,1100,1110,10,52:21.7,3
5/22/2021,20PNR1VA,2021 NBA Playoffs - Round 1 - Home Game A,5,1110,1100,-10,52:07.2,4
5/22/2021,20PNR1VA,2021 NBA Playoffs - Round 1 - Home Game A,5,1100,1110,10,52:06.1,5
5/22/2021,20PNR1VA,2021 NBA Playoffs - Round 1 - Home Game A,6,0,1360,1360,09:54.0,1
5/22/2021,20PNR1VA,2021 NBA Playoffs - Round 1 - Home Game A,6,1360,1100,-260,52:05.6,2
5/22/2021,20PNR1VA,2021 NBA Playoffs - Round 1 - Home Game A,6,1100,920,-180,52:53.2,3
5/22/2021,20PNR1VA,2021 NBA Playoffs - Round 1 - Home Game A,7,1325,1100,-225,52:05.6,1
5/22/2021,20PNR1VA,2021 NBA Playoffs - Round 1 - Home Game A,7,1100,870,-230,52:06.1,2
5/22/2021,20PNR1VA,2021 NBA Playoffs - Round 1 - Home Game A,8,930,1100,170,52:05.6,1
5/22/2021,20PNR1VA,2021 NBA Playoffs - Round 1 - Home Game A,8,1100,745,-355,52:30.7,2
5/22/2021,20PNR1VA,2021 NBA Playoffs - Round 1 - Home Game A,8,745,670,-75,52:05.6,3
5/22/2021,20PNR1VA,2021 NBA Playoffs - Round 1 - Home Game A,8,670,745,75,52:21.7,4
5/22/2021,20PNR1VA,2021 NBA Playoffs - Round 1 - Home Game A,8,745,670,-75,52:07.2,5
5/22/2021,20PNR1VA,2021 NBA Playoffs - Round 1 - Home Game A,9,895,1100,205,52:05.6,1
5/22/2021,20PNR1VA,2021 NBA Playoffs - Round 1 - Home Game A,9,1100,700,-400,52:30.7,2
5/22/2021,20PNR1VA,2021 NBA Playoffs - Round 1 - Home Game A,9,700,645,-55,52:05.6,3
5/22/2021,20PNR1VA,2021 NBA Playoffs - Round 1 - Home Game A,9,645,700,55,52:21.7,4
5/22/2021,20PNR1VA,2021 NBA Playoffs - Round 1 - Home Game A,9,700,645,-55,52:07.2,5
5/22/2021,20PNR1VA,2021 NBA Playoffs - Round 1 - Home Game A,A,0,845,845,09:54.1,1
5/22/2021,20PNR1VA,2021 NBA Playoffs - Round 1 - Home Game A,A,845,1100,255,52:05.6,2
5/22/2021,20PNR1VA,2021 NBA Playoffs - Round 1 - Home Game A,A,1100,985,-115,52:22.9,3
5/22/2021,20PNR1VA,2021 NBA Playoffs - Round 1 - Home Game A,A,985,580,-405,52:05.4,4
5/22/2021,20PNR1VA,2021 NBA Playoffs - Round 1 - Home Game A,A,580,625,45,52:04.8,5
5/22/2021,20PNR1VA,2021 NBA Playoffs - Round 1 - Home Game A,A,625,650,25,52:06.4,6
5/22/2021,20PNR1VA,2021 NBA Playoffs - Round 1 - Home Game A,A,650,680,30,52:12.6,7
5/22/2021,20PNR1VA,2021 NBA Playoffs - Round 1 - Home Game A,A,680,710,30,52:18.8,8
5/22/2021,20PNR1VA,2021 NBA Playoffs - Round 1 - Home Game A,A,710,745,35,52:05.5,9
5/22/2021,20PNR1VA,2021 NBA Playoffs - Round 1 - Home Game A,A,745,670,-75,52:30.7,10
5/22/2021,20PNR1VA,2021 NBA Playoffs - Round 1 - Home Game A,A,670,605,-65,52:05.6,11
5/22/2021,20PNR1VA,2021 NBA Playoffs - Round 1 - Home Game A,A,605,670,65,52:21.7,12
5/22/2021,20PNR1VA,2021 NBA Playoffs - Round 1 - Home Game A,A,670,605,-65,52:07.2,13
5/22/2021,20PNR1VA,2021 NBA Playoffs - Round 1 - Home Game A,A,605,595,-10,52:14.6,14
5/22/2021,20PNR1VA,2021 NBA Playoffs - Round 1 - Home Game A,B,0,770,770,09:54.2,1
5/22/2021,20PNR1VA,2021 NBA Playoffs - Round 1 - Home Game A,B,770,1100,330,52:05.6,2
5/22/2021,20PNR1VA,2021 NBA Playoffs - Round 1 - Home Game A,B,1100,960,-140,52:22.9,3
5/22/2021,20PNR1VA,2021 NBA Playoffs - Round 1 - Home Game A,B,960,560,-400,52:05.4,4
5/22/2021,20PNR1VA,2021 NBA Playoffs - Round 1 - Home Game A,B,560,600,40,52:04.8,5
5/22/2021,20PNR1VA,2021 NBA Playoffs - Round 1 - Home Game A,B,600,625,25,52:06.4,6
5/22/2021,20PNR1VA,2021 NBA Playoffs - Round 1 - Home Game A,B,625,650,25,52:12.6,7
5/22/2021,20PNR1VA,2021 NBA Playoffs - Round 1 - Home Game A,B,650,675,25,52:18.8,8
5/22/2021,20PNR1VA,2021 NBA Playoffs - Round 1 - Home Game A,B,675,700,25,52:05.5,9
5/22/2021,20PNR1VA,2021 NBA Playoffs - Round 1 - Home Game A,B,700,625,-75,52:30.7,10
5/22/2021,20PNR1VA,2021 NBA Playoffs - Round 1 - Home Game A,B,625,560,-65,52:05.6,11
5/22/2021,20PNR1VA,2021 NBA Playoffs - Round 1 - Home Game A,B,560,625,65,52:21.7,12
5/22/2021,20PNR1VA,2021 NBA Playoffs - Round 1 - Home Game A,B,625,560,-65,52:07.2,13
5/22/2021,20PNR1VA,2021 NBA Playoffs - Round 1 - Home Game A,B,560,450,-110,52:14.6,14
5/22/2021,20PNR1VA,2021 NBA Playoffs - Round 1 - Home Game A,C,0,705,705,09:54.3,1
5/22/2021,20PNR1VA,2021 NBA Playoffs - Round 1 - Home Game A,C,705,1100,395,52:05.6,2
5/22/2021,20PNR1VA,2021 NBA Playoffs - Round 1 - Home Game A,C,1100,905,-195,52:22.9,3
5/22/2021,20PNR1VA,2021 NBA Playoffs - Round 1 - Home Game A,C,905,530,-375,52:05.4,4
5/22/2021,20PNR1VA,2021 NBA Playoffs - Round 1 - Home Game A,C,530,570,40,52:04.8,5
5/22/2021,20PNR1VA,2021 NBA Playoffs - Round 1 - Home Game A,C,570,590,20,52:06.4,6
5/22/2021,20PNR1VA,2021 NBA Playoffs - Round 1 - Home Game A,C,590,620,30,52:12.6,7
5/22/2021,20PNR1VA,2021 NBA Playoffs - Round 1 - Home Game A,C,620,640,20,52:18.8,8
5/22/2021,20PNR1VA,2021 NBA Playoffs - Round 1 - Home Game A,C,640,670,30,52:05.5,9
5/22/2021,20PNR1VA,2021 NBA Playoffs - Round 1 - Home Game A,C,670,595,-75,52:30.7,10
5/22/2021,20PNR1VA,2021 NBA Playoffs - Round 1 - Home Game A,C,595,515,-80,52:05.6,11
5/22/2021,20PNR1VA,2021 NBA Playoffs - Round 1 - Home Game A,C,515,595,80,52:21.7,12
5/22/2021,20PNR1VA,2021 NBA Playoffs - Round 1 - Home Game A,C,595,440,-155,52:29.2,13
5/22/2021,20PNR1VA,2021 NBA Playoffs - Round 1 - Home Game A,C,440,420,-20,52:14.6,14
5/22/2021,20PNR1VA,2021 NBA Playoffs - Round 1 - Home Game A,D,0,675,675,09:54.4,1
5/22/2021,20PNR1VA,2021 NBA Playoffs - Round 1 - Home Game A,D,675,1100,425,52:05.6,2
5/22/2021,20PNR1VA,2021 NBA Playoffs - Round 1 - Home Game A,D,1100,825,-275,52:22.9,3
5/22/2021,20PNR1VA,2021 NBA Playoffs - Round 1 - Home Game A,D,825,480,-345,52:05.4,4
5/22/2021,20PNR1VA,2021 NBA Playoffs - Round 1 - Home Game A,D,480,515,35,52:04.8,5
5/22/2021,20PNR1VA,2021 NBA Playoffs - Round 1 - Home Game A,D,515,530,15,52:06.4,6
5/22/2021,20PNR1VA,2021 NBA Playoffs - Round 1 - Home Game A,D,530,560,30,52:12.6,7
5/22/2021,20PNR1VA,2021 NBA Playoffs - Round 1 - Home Game A,D,560,595,35,52:18.8,8
5/22/2021,20PNR1VA,2021 NBA Playoffs - Round 1 - Home Game A,D,595,625,30,52:05.5,9
5/22/2021,20PNR1VA,2021 NBA Playoffs - Round 1 - Home Game A,D,625,520,-105,52:30.7,10
5/22/2021,20PNR1VA,2021 NBA Playoffs - Round 1 - Home Game A,D,520,470,-50,52:05.6,11
5/22/2021,20PNR1VA,2021 NBA Playoffs - Round 1 - Home Game A,D,470,520,50,52:21.7,12
5/22/2021,20PNR1VA,2021 NBA Playoffs - Round 1 - Home Game A,D,520,420,-100,52:29.2,13
5/22/2021,20PNR1VA,2021 NBA Playoffs - Round 1 - Home Game A,D,420,400,-20,52:14.6,14
5/22/2021,20PNR1VA,2021 NBA Playoffs - Round 1 - Home Game A,E,0,565,565,09:54.5,1
5/22/2021,20PNR1VA,2021 NBA Playoffs - Round 1 - Home Game A,E,565,1100,535,52:05.6,2
5/22/2021,20PNR1VA,2021 NBA Playoffs - Round 1 - Home Game A,E,1100,755,-345,52:22.9,3
5/22/2021,20PNR1VA,2021 NBA Playoffs - Round 1 - Home Game A,E,755,445,-310,52:05.4,4
5/22/2021,20PNR1VA,2021 NBA Playoffs - Round 1 - Home Game A,E,445,480,35,52:04.8,5
5/22/2021,20PNR1VA,2021 NBA Playoffs - Round 1 - Home Game A,E,480,500,20,52:06.4,6
5/22/2021,20PNR1VA,2021 NBA Playoffs - Round 1 - Home Game A,E,500,525,25,52:12.6,7
5/22/2021,20PNR1VA,2021 NBA Playoffs - Round 1 - Home Game A,E,525,565,40,52:18.8,8
5/22/2021,20PNR1VA,2021 NBA Playoffs - Round 1 - Home Game A,E,565,595,30,52:05.5,9
5/22/2021,20PNR1VA,2021 NBA Playoffs - Round 1 - Home Game A,E,595,455,-140,52:30.7,10
5/22/2021,20PNR1VA,2021 NBA Playoffs - Round 1 - Home Game A,E,455,415,-40,52:05.6,11
5/22/2021,20PNR1VA,2021 NBA Playoffs - Round 1 - Home Game A,E,415,455,40,52:21.7,12
5/22/2021,20PNR1VA,2021 NBA Playoffs - Round 1 - Home Game A,E,455,360,-95,52:29.2,13
5/22/2021,20PNR1VA,2021 NBA Playoffs - Round 1 - Home Game A,E,360,335,-25,52:14.6,14
5/22/2021,20PNR1VA,2021 NBA Playoffs - Round 1 - Home Game A,F,0,535,535,09:54.6,1
5/22/2021,20PNR1VA,2021 NBA Playoffs - Round 1 - Home Game A,F,535,1100,565,52:05.6,2
5/22/2021,20PNR1VA,2021 NBA Playoffs - Round 1 - Home Game A,F,1100,720,-380,52:22.9,3
5/22/2021,20PNR1VA,2021 NBA Playoffs - Round 1 - Home Game A,F,720,425,-295,52:05.4,4
5/22/2021,20PNR1VA,2021 NBA Playoffs - Round 1 - Home Game A,F,425,455,30,52:04.8,5
5/22/2021,20PNR1VA,2021 NBA Playoffs - Round 1 - Home Game A,F,455,470,15,52:06.4,6
5/22/2021,20PNR1VA,2021 NBA Playoffs - Round 1 - Home Game A,F,470,490,20,52:24.7,7
5/22/2021,20PNR1VA,2021 NBA Playoffs - Round 1 - Home Game A,F,490,520,30,52:05.5,8
5/22/2021,20PNR1VA,2021 NBA Playoffs - Round 1 - Home Game A,F,520,435,-85,52:30.7,9
5/22/2021,20PNR1VA,2021 NBA Playoffs - Round 1 - Home Game A,F,435,390,-45,52:05.6,10
5/22/2021,20PNR1VA,2021 NBA Playoffs - Round 1 - Home Game A,F,390,435,45,52:21.7,11
5/22/2021,20PNR1VA,2021 NBA Playoffs - Round 1 - Home Game A,F,435,340,-95,52:29.2,12
5/22/2021,20PNR1VA,2021 NBA Playoffs - Round 1 - Home Game A,F,340,320,-20,52:14.6,13
5/22/2021,20PNR1VA,2021 NBA Playoffs - Round 1 - Home Game A,G,0,490,490,09:54.7,1
5/22/2021,20PNR1VA,2021 NBA Playoffs - Round 1 - Home Game A,G,490,1100,610,52:05.6,2
5/22/2021,20PNR1VA,2021 NBA Playoffs - Round 1 - Home Game A,G,1100,605,-495,52:22.9,3
5/22/2021,20PNR1VA,2021 NBA Playoffs - Round 1 - Home Game A,G,605,360,-245,52:05.4,4
5/22/2021,20PNR1VA,2021 NBA Playoffs - Round 1 - Home Game A,G,360,385,25,52:04.8,5
5/22/2021,20PNR1VA,2021 NBA Playoffs - Round 1 - Home Game A,G,385,405,20,52:06.4,6
5/22/2021,20PNR1VA,2021 NBA Playoffs - Round 1 - Home Game A,G,405,425,20,52:24.7,7
5/22/2021,20PNR1VA,2021 NBA Playoffs - Round 1 - Home Game A,G,425,455,30,52:05.5,8
5/22/2021,20PNR1VA,2021 NBA Playoffs - Round 1 - Home Game A,G,455,395,-60,52:30.7,9
5/22/2021,20PNR1VA,2021 NBA Playoffs - Round 1 - Home Game A,G,395,360,-35,52:05.6,10
5/22/2021,20PNR1VA,2021 NBA Playoffs - Round 1 - Home Game A,G,360,395,35,52:21.7,11
5/22/2021,20PNR1VA,2021 NBA Playoffs - Round 1 - Home Game A,G,395,320,-75,52:29.2,12
5/22/2021,20PNR1VA,2021 NBA Playoffs - Round 1 - Home Game A,G,320,295,-25,52:14.6,13
5/22/2021,20PNR1VA,2021 NBA Playoffs - Round 1 - Home Game A,H,0,450,450,09:54.8,1
5/22/2021,20PNR1VA,2021 NBA Playoffs - Round 1 - Home Game A,H,450,1100,650,52:05.6,2
5/22/2021,20PNR1VA,2021 NBA Playoffs - Round 1 - Home Game A,H,1100,575,-525,52:22.9,3
5/22/2021,20PNR1VA,2021 NBA Playoffs - Round 1 - Home Game A,H,575,340,-235,52:05.4,4
5/22/2021,20PNR1VA,2021 NBA Playoffs - Round 1 - Home Game A,H,340,365,25,52:04.8,5
5/22/2021,20PNR1VA,2021 NBA Playoffs - Round 1 - Home Game A,H,365,385,20,52:06.4,6
5/22/2021,20PNR1VA,2021 NBA Playoffs - Round 1 - Home Game A,H,385,405,20,52:24.7,7
5/22/2021,20PNR1VA,2021 NBA Playoffs - Round 1 - Home Game A,H,405,435,30,52:05.5,8
5/22/2021,20PNR1VA,2021 NBA Playoffs - Round 1 - Home Game A,H,435,365,-70,52:30.7,9
5/22/2021,20PNR1VA,2021 NBA Playoffs - Round 1 - Home Game A,H,365,335,-30,52:05.6,10
5/22/2021,20PNR1VA,2021 NBA Playoffs - Round 1 - Home Game A,H,335,365,30,52:21.7,11
5/22/2021,20PNR1VA,2021 NBA Playoffs - Round 1 - Home Game A,H,365,295,-70,52:29.2,12
5/22/2021,20PNR1VA,2021 NBA Playoffs - Round 1 - Home Game A,H,295,270,-25,52:14.6,13
5/22/2021,20PNR1VA,2021 NBA Playoffs - Round 1 - Home Game A,I,0,405,405,09:54.9,1
5/22/2021,20PNR1VA,2021 NBA Playoffs - Round 1 - Home Game A,I,405,1100,695,52:05.6,2
5/22/2021,20PNR1VA,2021 NBA Playoffs - Round 1 - Home Game A,I,1100,525,-575,52:22.9,3
5/22/2021,20PNR1VA,2021 NBA Playoffs - Round 1 - Home Game A,I,525,315,-210,52:05.4,4
5/22/2021,20PNR1VA,2021 NBA Playoffs - Round 1 - Home Game A,I,315,340,25,52:04.8,5
5/22/2021,20PNR1VA,2021 NBA Playoffs - Round 1 - Home Game A,I,340,355,15,52:06.4,6
5/22/2021,20PNR1VA,2021 NBA Playoffs - Round 1 - Home Game A,I,355,375,20,52:24.7,7
5/22/2021,20PNR1VA,2021 NBA Playoffs - Round 1 - Home Game A,I,375,395,20,52:05.5,8
5/22/2021,20PNR1VA,2021 NBA Playoffs - Round 1 - Home Game A,I,395,335,-60,52:30.7,9
5/22/2021,20PNR1VA,2021 NBA Playoffs - Round 1 - Home Game A,I,335,305,-30,52:05.6,10
5/22/2021,20PNR1VA,2021 NBA Playoffs - Round 1 - Home Game A,I,305,335,30,52:21.7,11
5/22/2021,20PNR1VA,2021 NBA Playoffs - Round 1 - Home Game A,I,335,270,-65,52:29.2,12
5/22/2021,20PNR1VA,2021 NBA Playoffs - Round 1 - Home Game A,I,270,250,-20,52:14.6,13
5/22/2021,20PNR1VA,2021 NBA Playoffs - Round 1 - Home Game A,J,0,375,375,09:55.0,1
5/22/2021,20PNR1VA,2021 NBA Playoffs - Round 1 - Home Game A,J,375,1100,725,52:05.6,2
5/22/2021,20PNR1VA,2021 NBA Playoffs - Round 1 - Home Game A,J,1100,485,-615,52:22.9,3
5/22/2021,20PNR1VA,2021 NBA Playoffs - Round 1 - Home Game A,J,485,290,-195,52:05.4,4
5/22/2021,20PNR1VA,2021 NBA Playoffs - Round 1 - Home Game A,J,290,310,20,52:04.8,5
5/22/2021,20PNR1VA,2021 NBA Playoffs - Round 1 - Home Game A,J,310,325,15,52:06.4,6
5/22/2021,20PNR1VA,2021 NBA Playoffs - Round 1 - Home Game A,J,325,345,20,52:24.7,7
5/22/2021,20PNR1VA,2021 NBA Playoffs - Round 1 - Home Game A,J,345,365,20,52:05.5,8
5/22/2021,20PNR1VA,2021 NBA Playoffs - Round 1 - Home Game A,J,365,320,-45,52:30.7,9
5/22/2021,20PNR1VA,2021 NBA Playoffs - Round 1 - Home Game A,J,320,280,-40,52:05.6,10
5/22/2021,20PNR1VA,2021 NBA Playoffs - Round 1 - Home Game A,J,280,320,40,52:21.7,11
5/22/2021,20PNR1VA,2021 NBA Playoffs - Round 1 - Home Game A,J,320,255,-65,52:29.2,12
5/22/2021,20PNR1VA,2021 NBA Playoffs - Round 1 - Home Game A,J,255,235,-20,52:14.6,13
5/22/2021,20PNR1VA,2021 NBA Playoffs - Round 1 - Home Game A,K,0,350,350,09:55.1,1
5/22/2021,20PNR1VA,2021 NBA Playoffs - Round 1 - Home Game A,K,350,1100,750,52:05.6,2
5/22/2021,20PNR1VA,2021 NBA Playoffs - Round 1 - Home Game A,K,1100,435,-665,52:22.9,3
5/22/2021,20PNR1VA,2021 NBA Playoffs - Round 1 - Home Game A,K,435,265,-170,52:05.4,4
5/22/2021,20PNR1VA,2021 NBA Playoffs - Round 1 - Home Game A,K,265,285,20,52:04.8,5
5/22/2021,20PNR1VA,2021 NBA Playoffs - Round 1 - Home Game A,K,285,299,14,52:06.4,6
5/22/2021,20PNR1VA,2021 NBA Playoffs - Round 1 - Home Game A,K,299,310,11,52:24.7,7
5/22/2021,20PNR1VA,2021 NBA Playoffs - Round 1 - Home Game A,K,310,335,25,52:05.5,8
5/22/2021,20PNR1VA,2021 NBA Playoffs - Round 1 - Home Game A,K,335,305,-30,52:30.7,9
5/22/2021,20PNR1VA,2021 NBA Playoffs - Round 1 - Home Game A,K,305,265,-40,52:05.6,10
5/22/2021,20PNR1VA,2021 NBA Playoffs - Round 1 - Home Game A,K,265,305,40,52:21.7,11
5/22/2021,20PNR1VA,2021 NBA Playoffs - Round 1 - Home Game A,K,305,240,-65,52:29.2,12
5/22/2021,20PNR1VA,2021 NBA Playoffs - Round 1 - Home Game A,K,240,220,-20,52:14.6,13
5/22/2021,20PNR1VA,2021 NBA Playoffs - Round 1 - Home Game A,L,0,340,340,09:55.2,1
5/22/2021,20PNR1VA,2021 NBA Playoffs - Round 1 - Home Game A,L,340,1100,760,52:05.6,2
5/22/2021,20PNR1VA,2021 NBA Playoffs - Round 1 - Home Game A,L,1100,400,-700,52:22.9,3
5/22/2021,20PNR1VA,2021 NBA Playoffs - Round 1 - Home Game A,L,400,245,-155,52:05.4,4
5/22/2021,20PNR1VA,2021 NBA Playoffs - Round 1 - Home Game A,L,245,265,20,52:04.8,5
5/22/2021,20PNR1VA,2021 NBA Playoffs - Round 1 - Home Game A,L,265,280,15,52:06.4,6
5/22/2021,20PNR1VA,2021 NBA Playoffs - Round 1 - Home Game A,L,280,295,15,52:24.7,7
5/22/2021,20PNR1VA,2021 NBA Playoffs - Round 1 - Home Game A,L,295,320,25,52:05.5,8
5/22/2021,20PNR1VA,2021 NBA Playoffs - Round 1 - Home Game A,L,320,289,-31,52:30.7,9
5/22/2021,20PNR1VA,2021 NBA Playoffs - Round 1 - Home Game A,L,289,255,-34,52:05.6,10
5/22/2021,20PNR1VA,2021 NBA Playoffs - Round 1 - Home Game A,L,255,289,34,52:21.7,11
5/22/2021,20PNR1VA,2021 NBA Playoffs - Round 1 - Home Game A,L,289,235,-54,52:29.2,12
5/22/2021,20PNR1VA,2021 NBA Playoffs - Round 1 - Home Game A,L,235,215,-20,52:14.6,13
5/22/2021,20PNR1VA,2021 NBA Playoffs - Round 1 - Home Game A,M,0,300,300,09:55.3,1
5/22/2021,20PNR1VA,2021 NBA Playoffs - Round 1 - Home Game A,M,300,1100,800,52:05.6,2
5/22/2021,20PNR1VA,2021 NBA Playoffs - Round 1 - Home Game A,M,1100,370,-730,52:22.9,3
5/22/2021,20PNR1VA,2021 NBA Playoffs - Round 1 - Home Game A,M,370,230,-140,52:05.4,4
5/22/2021,20PNR1VA,2021 NBA Playoffs - Round 1 - Home Game A,M,230,245,15,52:04.8,5
5/22/2021,20PNR1VA,2021 NBA Playoffs - Round 1 - Home Game A,M,245,260,15,52:06.4,6
5/22/2021,20PNR1VA,2021 NBA Playoffs - Round 1 - Home Game A,M,260,275,15,52:24.7,7
5/22/2021,20PNR1VA,2021 NBA Playoffs - Round 1 - Home Game A,M,275,305,30,52:05.5,8
5/22/2021,20PNR1VA,2021 NBA Playoffs - Round 1 - Home Game A,M,305,269,-36,52:30.7,9
5/22/2021,20PNR1VA,2021 NBA Playoffs - Round 1 - Home Game A,M,269,240,-29,52:05.6,10
5/22/2021,20PNR1VA,2021 NBA Playoffs - Round 1 - Home Game A,M,240,269,29,52:21.7,11
5/22/2021,20PNR1VA,2021 NBA Playoffs - Round 1 - Home Game A,M,269,220,-49,52:29.2,12
5/22/2021,20PNR1VA,2021 NBA Playoffs - Round 1 - Home Game A,M,220,190,-30,52:14.6,13
5/22/2021,20PNR1VA,2021 NBA Playoffs - Round 1 - Home Game A,N,0,495,495,09:55.4,1
5/22/2021,20PNR1VA,2021 NBA Playoffs - Round 1 - Home Game A,N,495,1100,605,52:05.6,2
5/22/2021,20PNR1VA,2021 NBA Playoffs - Round 1 - Home Game A,N,1100,365,-735,52:22.9,3
5/22/2021,20PNR1VA,2021 NBA Playoffs - Round 1 - Home Game A,N,365,225,-140,52:05.4,4
5/22/2021,20PNR1VA,2021 NBA Playoffs - Round 1 - Home Game A,N,225,240,15,52:04.8,5
5/22/2021,20PNR1VA,2021 NBA Playoffs - Round 1 - Home Game A,N,240,250,10,52:06.4,6
5/22/2021,20PNR1VA,2021 NBA Playoffs - Round 1 - Home Game A,N,250,260,10,52:24.7,7
5/22/2021,20PNR1VA,2021 NBA Playoffs - Round 1 - Home Game A,N,260,289,29,52:05.5,8
5/22/2021,20PNR1VA,2021 NBA Playoffs - Round 1 - Home Game A,N,289,395,106,52:30.7,9
5/22/2021,20PNR1VA,2021 NBA Playoffs - Round 1 - Home Game A,N,395,360,-35,52:05.6,10
5/22/2021,20PNR1VA,2021 NBA Playoffs - Round 1 - Home Game A,N,360,395,35,52:21.7,11
5/22/2021,20PNR1VA,2021 NBA Playoffs - Round 1 - Home Game A,N,395,330,-65,52:29.2,12
5/22/2021,20PNR1VA,2021 NBA Playoffs - Round 1 - Home Game A,N,330,310,-20,52:14.6,13
5/22/2021,20PNR1VA,2021 NBA Playoffs - Round 1 - Home Game A,O,0,445,445,09:55.5,1
5/22/2021,20PNR1VA,2021 NBA Playoffs - Round 1 - Home Game A,O,445,1100,655,52:05.6,2
5/22/2021,20PNR1VA,2021 NBA Playoffs - Round 1 - Home Game A,O,1100,320,-780,52:22.9,3
5/22/2021,20PNR1VA,2021 NBA Playoffs - Round 1 - Home Game A,O,320,200,-120,52:05.4,4
5/22/2021,20PNR1VA,2021 NBA Playoffs - Round 1 - Home Game A,O,200,215,15,52:04.8,5
5/22/2021,20PNR1VA,2021 NBA Playoffs - Round 1 - Home Game A,O,215,230,15,52:06.4,6
5/22/2021,20PNR1VA,2021 NBA Playoffs - Round 1 - Home Game A,O,230,245,15,52:24.7,7
5/22/2021,20PNR1VA,2021 NBA Playoffs - Round 1 - Home Game A,O,245,269,24,52:05.5,8
5/22/2021,20PNR1VA,2021 NBA Playoffs - Round 1 - Home Game A,O,269,355,86,52:30.7,9
5/22/2021,20PNR1VA,2021 NBA Playoffs - Round 1 - Home Game A,O,355,320,-35,52:05.6,10
5/22/2021,20PNR1VA,2021 NBA Playoffs - Round 1 - Home Game A,O,320,355,35,52:21.7,11
5/22/2021,20PNR1VA,2021 NBA Playoffs - Round 1 - Home Game A,O,355,285,-70,52:29.2,12
5/22/2021,20PNR1VA,2021 NBA Playoffs - Round 1 - Home Game A,O,285,275,-10,52:14.6,13
5/22/2021,20PNR1VA,2021 NBA Playoffs - Round 1 - Home Game A,P,0,390,390,09:55.7,1
5/22/2021,20PNR1VA,2021 NBA Playoffs - Round 1 - Home Game A,P,390,1100,710,52:05.6,2
5/22/2021,20PNR1VA,2021 NBA Playoffs - Round 1 - Home Game A,P,1100,530,-570,52:22.9,3
5/22/2021,20PNR1VA,2021 NBA Playoffs - Round 1 - Home Game A,P,530,330,-200,52:05.4,4
5/22/2021,20PNR1VA,2021 NBA Playoffs - Round 1 - Home Game A,P,330,355,25,52:04.8,5
5/22/2021,20PNR1VA,2021 NBA Playoffs - Round 1 - Home Game A,P,355,375,20,52:18.8,6
5/22/2021,20PNR1VA,2021 NBA Playoffs - Round 1 - Home Game A,P,375,395,20,52:05.5,7
5/22/2021,20PNR1VA,2021 NBA Playoffs - Round 1 - Home Game A,P,395,330,-65,52:30.7,8
5/22/2021,20PNR1VA,2021 NBA Playoffs - Round 1 - Home Game A,P,330,299,-31,52:05.6,9
5/22/2021,20PNR1VA,2021 NBA Playoffs - Round 1 - Home Game A,P,299,330,31,52:21.7,10
5/22/2021,20PNR1VA,2021 NBA Playoffs - Round 1 - Home Game A,P,330,270,-60,52:29.2,11
5/22/2021,20PNR1VA,2021 NBA Playoffs - Round 1 - Home Game A,P,270,245,-25,52:14.6,12
5/22/2021,20PNR1VA,2021 NBA Playoffs - Round 1 - Home Game A,Q,0,315,315,09:55.8,1
5/22/2021,20PNR1VA,2021 NBA Playoffs - Round 1 - Home Game A,Q,315,1100,785,52:05.6,2
5/22/2021,20PNR1VA,2021 NBA Playoffs - Round 1 - Home Game A,Q,1100,475,-625,52:22.9,3
5/22/2021,20PNR1VA,2021 NBA Playoffs - Round 1 - Home Game A,Q,475,295,-180,52:05.4,4
5/22/2021,20PNR1VA,2021 NBA Playoffs - Round 1 - Home Game A,Q,295,315,20,52:04.8,5
5/22/2021,20PNR1VA,2021 NBA Playoffs - Round 1 - Home Game A,Q,315,335,20,52:18.8,6
5/22/2021,20PNR1VA,2021 NBA Playoffs - Round 1 - Home Game A,Q,335,355,20,52:05.5,7
5/22/2021,20PNR1VA,2021 NBA Playoffs - Round 1 - Home Game A,Q,355,260,-95,52:30.7,8
5/22/2021,20PNR1VA,2021 NBA Playoffs - Round 1 - Home Game A,Q,260,235,-25,52:05.6,9
5/22/2021,20PNR1VA,2021 NBA Playoffs - Round 1 - Home Game A,Q,235,260,25,52:21.7,10
5/22/2021,20PNR1VA,2021 NBA Playoffs - Round 1 - Home Game A,Q,260,250,-10,52:29.2,11
5/22/2021,20PNR1VA,2021 NBA Playoffs - Round 1 - Home Game A,Q,250,200,-50,52:14.6,12
5/22/2021,20PNR1VA,2021 NBA Playoffs - Round 1 - Home Game A,R,0,280,280,09:55.9,1
5/22/2021,20PNR1VA,2021 NBA Playoffs - Round 1 - Home Game A,R,280,1100,820,52:05.6,2
5/22/2021,20PNR1VA,2021 NBA Playoffs - Round 1 - Home Game A,R,1100,420,-680,52:22.9,3
5/22/2021,20PNR1VA,2021 NBA Playoffs - Round 1 - Home Game A,R,420,260,-160,52:05.4,4
5/22/2021,20PNR1VA,2021 NBA Playoffs - Round 1 - Home Game A,R,260,280,20,52:04.8,5
5/22/2021,20PNR1VA,2021 NBA Playoffs - Round 1 - Home Game A,R,280,305,25,52:18.8,6
5/22/2021,20PNR1VA,2021 NBA Playoffs - Round 1 - Home Game A,R,305,330,25,52:05.5,7
5/22/2021,20PNR1VA,2021 NBA Playoffs - Round 1 - Home Game A,R,330,225,-105,52:30.7,8
5/22/2021,20PNR1VA,2021 NBA Playoffs - Round 1 - Home Game A,R,225,205,-20,52:05.6,9
5/22/2021,20PNR1VA,2021 NBA Playoffs - Round 1 - Home Game A,R,205,225,20,52:21.7,10
5/22/2021,20PNR1VA,2021 NBA Playoffs - Round 1 - Home Game A,R,225,220,-5,52:29.2,11
5/22/2021,20PNR1VA,2021 NBA Playoffs - Round 1 - Home Game A,R,220,175,-45,52:14.6,12
5/22/2021,20PNR1VA,2021 NBA Playoffs - Round 1 - Home Game A,S,0,280,280,09:56.0,1
5/22/2021,20PNR1VA,2021 NBA Playoffs - Round 1 - Home Game A,S,280,1100,820,52:05.6,2
5/22/2021,20PNR1VA,2021 NBA Playoffs - Round 1 - Home Game A,S,1100,335,-765,52:22.9,3
5/22/2021,20PNR1VA,2021 NBA Playoffs - Round 1 - Home Game A,S,335,210,-125,52:05.4,4
5/22/2021,20PNR1VA,2021 NBA Playoffs - Round 1 - Home Game A,S,210,225,15,52:04.8,5
5/22/2021,20PNR1VA,2021 NBA Playoffs - Round 1 - Home Game A,S,225,240,15,52:18.8,6
5/22/2021,20PNR1VA,2021 NBA Playoffs - Round 1 - Home Game A,S,240,260,20,52:05.5,7
5/22/2021,20PNR1VA,2021 NBA Playoffs - Round 1 - Home Game A,S,260,230,-30,52:30.7,8
5/22/2021,20PNR1VA,2021 NBA Playoffs - Round 1 - Home Game A,S,230,205,-25,52:05.6,9
5/22/2021,20PNR1VA,2021 NBA Playoffs - Round 1 - Home Game A,S,205,230,25,52:21.7,10
5/22/2021,20PNR1VA,2021 NBA Playoffs - Round 1 - Home Game A,S,230,220,-10,52:29.2,11
5/22/2021,20PNR1VA,2021 NBA Playoffs - Round 1 - Home Game A,S,220,175,-45,52:14.6,12
5/22/2021,20PNR1VA,2021 NBA Playoffs - Round 1 - Home Game A,T,0,230,230,09:56.1,1
5/22/2021,20PNR1VA,2021 NBA Playoffs - Round 1 - Home Game A,T,230,1750,1520,52:05.6,2
5/22/2021,20PNR1VA,2021 NBA Playoffs - Round 1 - Home Game A,T,1750,300,-1450,52:22.9,3
5/22/2021,20PNR1VA,2021 NBA Playoffs - Round 1 - Home Game A,T,300,185,-115,52:05.4,4
5/22/2021,20PNR1VA,2021 NBA Playoffs - Round 1 - Home Game A,T,185,200,15,52:04.8,5
5/22/2021,20PNR1VA,2021 NBA Playoffs - Round 1 - Home Game A,T,200,215,15,52:18.8,6
5/22/2021,20PNR1VA,2021 NBA Playoffs - Round 1 - Home Game A,T,215,230,15,52:05.5,7
5/22/2021,20PNR1VA,2021 NBA Playoffs - Round 1 - Home Game A,T,230,225,-5,52:12.2,8
5/22/2021,20PNR1VA,2021 NBA Playoffs - Round 1 - Home Game A,T,225,205,-20,52:30.7,9
5/22/2021,20PNR1VA,2021 NBA Playoffs - Round 1 - Home Game A,T,205,199,-6,52:05.6,10
5/22/2021,20PNR1VA,2021 NBA Playoffs - Round 1 - Home Game A,T,199,205,6,52:21.7,11
5/22/2021,20PNR1VA,2021 NBA Playoffs - Round 1 - Home Game A,T,205,150,-55,52:14.6,12
5/22/2021,20PNR1VA,2021 NBA Playoffs - Round 1 - Home Game A,T,150,165,15,52:13.9,13
5/22/2021,20PNR1VA,2021 NBA Playoffs - Round 1 - Home Game A,U,0,205,205,09:56.2,1
5/22/2021,20PNR1VA,2021 NBA Playoffs - Round 1 - Home Game A,U,205,1100,895,52:05.6,2
5/22/2021,20PNR1VA,2021 NBA Playoffs - Round 1 - Home Game A,U,1100,300,-800,52:22.9,3
5/22/2021,20PNR1VA,2021 NBA Playoffs - Round 1 - Home Game A,U,300,185,-115,52:05.4,4
5/22/2021,20PNR1VA,2021 NBA Playoffs - Round 1 - Home Game A,U,185,200,15,52:04.8,5
5/22/2021,20PNR1VA,2021 NBA Playoffs - Round 1 - Home Game A,U,200,215,15,52:18.8,6
5/22/2021,20PNR1VA,2021 NBA Playoffs - Round 1 - Home Game A,U,215,230,15,52:05.5,7
5/22/2021,20PNR1VA,2021 NBA Playoffs - Round 1 - Home Game A,U,230,179,-51,52:30.7,8
5/22/2021,20PNR1VA,2021 NBA Playoffs - Round 1 - Home Game A,U,179,135,-44,52:14.6,9
5/22/2021,20PNR1VA,2021 NBA Playoffs - Round 1 - Home Game A,U,135,145,10,52:13.9,10
5/22/2021,20PNR1VA,2021 NBA Playoffs - Round 1 - Home Game A,V,0,185,185,09:56.3,1
5/22/2021,20PNR1VA,2021 NBA Playoffs - Round 1 - Home Game A,V,185,1100,915,52:05.6,2
5/22/2021,20PNR1VA,2021 NBA Playoffs - Round 1 - Home Game A,V,1100,245,-855,52:22.9,3
5/22/2021,20PNR1VA,2021 NBA Playoffs - Round 1 - Home Game A,V,245,160,-85,52:05.4,4
5/22/2021,20PNR1VA,2021 NBA Playoffs - Round 1 - Home Game A,V,160,170,10,52:04.8,5
5/22/2021,20PNR1VA,2021 NBA Playoffs - Round 1 - Home Game A,V,170,185,15,52:18.8,6
5/22/2021,20PNR1VA,2021 NBA Playoffs - Round 1 - Home Game A,V,185,205,20,52:05.5,7
5/22/2021,20PNR1VA,2021 NBA Playoffs - Round 1 - Home Game A,V,205,169,-36,52:30.7,8
5/22/2021,20PNR1VA,2021 NBA Playoffs - Round 1 - Home Game A,V,169,120,-49,52:14.6,9
5/22/2021,20PNR1VA,2021 NBA Playoffs - Round 1 - Home Game A,V,120,130,10,52:13.9,10
5/22/2021,20PNR1VA,2021 NBA Playoffs - Round 1 - Home Game A,W,0,175,175,09:56.4,1
5/22/2021,20PNR1VA,2021 NBA Playoffs - Round 1 - Home Game A,W,175,1100,925,52:05.6,2
5/22/2021,20PNR1VA,2021 NBA Playoffs - Round 1 - Home Game A,W,1100,220,-880,52:22.9,3
5/22/2021,20PNR1VA,2021 NBA Playoffs - Round 1 - Home Game A,W,220,140,-80,52:05.4,4
5/22/2021,20PNR1VA,2021 NBA Playoffs - Round 1 - Home Game A,W,140,145,5,52:04.8,5
5/22/2021,20PNR1VA,2021 NBA Playoffs - Round 1 - Home Game A,W,145,160,15,52:18.8,6
5/22/2021,20PNR1VA,2021 NBA Playoffs - Round 1 - Home Game A,W,160,179,19,52:05.5,7
5/22/2021,20PNR1VA,2021 NBA Playoffs - Round 1 - Home Game A,W,179,145,-34,52:30.7,8
5/22/2021,20PNR1VA,2021 NBA Playoffs - Round 1 - Home Game A,W,145,110,-35,52:14.6,9
5/22/2021,20PNR1VA,2021 NBA Playoffs - Round 1 - Home Game A,W,110,120,10,52:13.9,10
5/22/2021,20PNR1VA,2021 NBA Playoffs - Round 1 - Home Game A,X,0,155,155,09:56.5,1
5/22/2021,20PNR1VA,2021 NBA Playoffs - Round 1 - Home Game A,X,155,1100,945,52:05.6,2
5/22/2021,20PNR1VA,2021 NBA Playoffs - Round 1 - Home Game A,X,1100,620,-480,52:22.9,3
5/22/2021,20PNR1VA,2021 NBA Playoffs - Round 1 - Home Game A,X,620,350,-270,52:05.4,4
5/22/2021,20PNR1VA,2021 NBA Playoffs - Round 1 - Home Game A,X,350,375,25,52:04.8,5
5/22/2021,20PNR1VA,2021 NBA Playoffs - Round 1 - Home Game A,X,375,395,20,52:05.5,6
5/22/2021,20PNR1VA,2021 NBA Playoffs - Round 1 - Home Game A,X,395,415,20,52:07.6,7
5/22/2021,20PNR1VA,2021 NBA Playoffs - Round 1 - Home Game A,X,415,139,-276,52:30.7,8
5/22/2021,20PNR1VA,2021 NBA Playoffs - Round 1 - Home Game A,X,139,99,-40,52:14.6,9
5/22/2021,20PNR1VA,2021 NBA Playoffs - Round 1 - Home Game A,X,99,105,6,52:13.9,10
5/22/2021,20PNR1VA,2021 NBA Playoffs - Round 1 - Home Game A,X,105,110,5,52:13.8,11
5/22/2021,20PNR1VA,2021 NBA Playoffs - Round 1 - Home Game A,Y,0,150,150,09:56.6,1
5/22/2021,20PNR1VA,2021 NBA Playoffs - Round 1 - Home Game A,Y,150,1100,950,52:05.6,2
5/22/2021,20PNR1VA,2021 NBA Playoffs - Round 1 - Home Game A,Y,1100,129,-971,52:30.7,3
5/22/2021,20PNR1VA,2021 NBA Playoffs - Round 1 - Home Game A,Y,129,95,-34,52:14.6,4
5/22/2021,20PNR1VA,2021 NBA Playoffs - Round 1 - Home Game A,Y,95,99,4,52:13.9,5
5/22/2021,20PNR1VA,2021 NBA Playoffs - Round 1 - Home Game A,Y,99,105,6,52:13.8,6
5/22/2021,20PNR1VA,2021 NBA Playoffs - Round 1 - Home Game A,Z,0,580,580,09:56.7,1
5/22/2021,20PNR1VA,2021 NBA Playoffs - Round 1 - Home Game A,Z,580,1100,520,52:05.6,2
5/22/2021,20PNR1VA,2021 NBA Playoffs - Round 1 - Home Game A,Z,1100,415,-685,52:30.7,3
5/22/2021,20PNR1VA,2021 NBA Playoffs - Round 1 - Home Game A,Z,415,330,-85,52:14.6,4
5/25/2021,20PNR1GB,2021 NBA Playoffs - Round 1 - Home Game B,1,0,236500,236500,32:42.9,1
5/25/2021,20PNR1GB,2021 NBA Playoffs - Round 1 - Home Game B,1,236500,157500,-79000,16:39.2,2
5/25/2021,20PNR1GB,2021 NBA Playoffs - Round 1 - Home Game B,1,157500,6050,-151450,34:56.5,3
5/25/2021,20PNR1GB,2021 NBA Playoffs - Round 1 - Home Game B,1,6050,1100,-4950,52:05.6,4
5/25/2021,20PNR1GB,2021 NBA Playoffs - Round 1 - Home Game B,1,1100,6500,5400,52:25.5,5
5/25/2021,20PNR1GB,2021 NBA Playoffs - Round 1 - Home Game B,1,6500,8000,1500,52:31.7,6
5/25/2021,20PNR1GB,2021 NBA Playoffs - Round 1 - Home Game B,1,8000,6000,-2000,52:05.6,7
5/25/2021,20PNR1GB,2021 NBA Playoffs - Round 1 - Home Game B,2,0,98900,98900,32:43.0,1
5/25/2021,20PNR1GB,2021 NBA Playoffs - Round 1 - Home Game B,2,98900,6050,-92850,34:56.5,2
5/25/2021,20PNR1GB,2021 NBA Playoffs - Round 1 - Home Game B,2,6050,1100,-4950,52:05.6,3
5/25/2021,20PNR1GB,2021 NBA Playoffs - Round 1 - Home Game B,2,1100,6500,5400,52:25.5,4
5/25/2021,20PNR1GB,2021 NBA Playoffs - Round 1 - Home Game B,2,6500,8000,1500,52:31.7,5
5/25/2021,20PNR1GB,2021 NBA Playoffs - Round 1 - Home Game B,2,8000,6000,-2000,52:05.6,6
5/25/2021,20PNR1GB,2021 NBA Playoffs - Round 1 - Home Game B,3,0,85979,85979,32:43.1,1
5/25/2021,20PNR1GB,2021 NBA Playoffs - Round 1 - Home Game B,3,85979,157500,71521,16:39.3,2
5/25/2021,20PNR1GB,2021 NBA Playoffs - Round 1 - Home Game B,3,157500,6050,-151450,34:56.5,3
5/25/2021,20PNR1GB,2021 NBA Playoffs - Round 1 - Home Game B,3,6050,1100,-4950,52:05.6,4
5/25/2021,20PNR1GB,2021 NBA Playoffs - Round 1 - Home Game B,3,1100,6500,5400,52:25.5,5
5/25/2021,20PNR1GB,2021 NBA Playoffs - Round 1 - Home Game B,3,6500,8000,1500,52:31.7,6
5/25/2021,20PNR1GB,2021 NBA Playoffs - Round 1 - Home Game B,3,8000,6000,-2000,52:05.6,7
5/25/2021,20PNR1GB,2021 NBA Playoffs - Round 1 - Home Game B,4,0,47300,47300,32:43.2,1
5/25/2021,20PNR1GB,2021 NBA Playoffs - Round 1 - Home Game B,4,47300,114540,67240,16:39.4,2
5/25/2021,20PNR1GB,2021 NBA Playoffs - Round 1 - Home Game B,4,114540,4400,-110140,34:56.5,3
5/25/2021,20PNR1GB,2021 NBA Playoffs - Round 1 - Home Game B,4,4400,1100,-3300,52:05.6,4
5/25/2021,20PNR1GB,2021 NBA Playoffs - Round 1 - Home Game B,4,1100,6500,5400,52:25.5,5
5/25/2021,20PNR1GB,2021 NBA Playoffs - Round 1 - Home Game B,4,6500,8000,1500,52:31.7,6
5/25/2021,20PNR1GB,2021 NBA Playoffs - Round 1 - Home Game B,4,8000,6000,-2000,52:05.6,7
5/25/2021,20PNR1GB,2021 NBA Playoffs - Round 1 - Home Game B,5,0,43000,43000,32:43.3,1
5/25/2021,20PNR1GB,2021 NBA Playoffs - Round 1 - Home Game B,5,43000,59120,16120,16:39.5,2
5/25/2021,20PNR1GB,2021 NBA Playoffs - Round 1 - Home Game B,5,59120,1960,-57160,34:56.5,3
5/25/2021,20PNR1GB,2021 NBA Playoffs - Round 1 - Home Game B,5,1960,1820,-140,54:56.8,4
5/25/2021,20PNR1GB,2021 NBA Playoffs - Round 1 - Home Game B,5,1960,1820,-140,54:56.8,5
5/25/2021,20PNR1GB,2021 NBA Playoffs - Round 1 - Home Game B,5,1820,1100,-720,52:05.6,6
5/25/2021,20PNR1GB,2021 NBA Playoffs - Round 1 - Home Game B,5,1100,4500,3400,52:25.5,7
5/25/2021,20PNR1GB,2021 NBA Playoffs - Round 1 - Home Game B,5,4500,3850,-650,52:05.6,8
5/25/2021,20PNR1GB,2021 NBA Playoffs - Round 1 - Home Game B,5,3850,1780,-2070,52:05.0,9
5/25/2021,20PNR1GB,2021 NBA Playoffs - Round 1 - Home Game B,5,1780,1300,-480,52:05.1,10
5/25/2021,20PNR1GB,2021 NBA Playoffs - Round 1 - Home Game B,5,1300,1150,-150,52:06.4,11
5/25/2021,20PNR1GB,2021 NBA Playoffs - Round 1 - Home Game B,5,1150,1110,-40,52:05.3,12
5/25/2021,20PNR1GB,2021 NBA Playoffs - Round 1 - Home Game B,6,0,30100,30100,32:43.4,1
5/25/2021,20PNR1GB,2021 NBA Playoffs - Round 1 - Home Game B,6,30100,41100,11000,16:39.6,2
5/25/2021,20PNR1GB,2021 NBA Playoffs - Round 1 - Home Game B,6,41100,1360,-39740,34:56.5,3
5/25/2021,20PNR1GB,2021 NBA Playoffs - Round 1 - Home Game B,6,1360,1100,-260,52:05.6,4
5/25/2021,20PNR1GB,2021 NBA Playoffs - Round 1 - Home Game B,6,1100,2920,1820,52:25.5,5
5/25/2021,20PNR1GB,2021 NBA Playoffs - Round 1 - Home Game B,6,2920,2480,-440,52:05.6,6
5/25/2021,20PNR1GB,2021 NBA Playoffs - Round 1 - Home Game B,6,2480,1470,-1010,52:05.0,7
5/25/2021,20PNR1GB,2021 NBA Playoffs - Round 1 - Home Game B,6,1470,1100,-370,52:05.1,8
5/25/2021,20PNR1GB,2021 NBA Playoffs - Round 1 - Home Game B,6,1100,930,-170,52:06.4,9
5/25/2021,20PNR1GB,2021 NBA Playoffs - Round 1 - Home Game B,6,930,920,-10,52:05.3,10
5/25/2021,20PNR1GB,2021 NBA Playoffs - Round 1 - Home Game B,7,23650,38610,14960,16:39.6,1
5/25/2021,20PNR1GB,2021 NBA Playoffs - Round 1 - Home Game B,7,38610,1280,-37330,34:56.5,2
5/25/2021,20PNR1GB,2021 NBA Playoffs - Round 1 - Home Game B,7,1280,1325,45,54:56.8,3
5/25/2021,20PNR1GB,2021 NBA Playoffs - Round 1 - Home Game B,7,1280,1325,45,54:56.8,4
5/25/2021,20PNR1GB,2021 NBA Playoffs - Round 1 - Home Game B,7,1325,1100,-225,52:05.6,5
5/25/2021,20PNR1GB,2021 NBA Playoffs - Round 1 - Home Game B,7,1100,2100,1000,52:25.5,6
5/25/2021,20PNR1GB,2021 NBA Playoffs - Round 1 - Home Game B,7,2100,1790,-310,52:05.6,7
5/25/2021,20PNR1GB,2021 NBA Playoffs - Round 1 - Home Game B,7,1790,1390,-400,52:05.0,8
5/25/2021,20PNR1GB,2021 NBA Playoffs - Round 1 - Home Game B,7,1390,1050,-340,52:05.1,9
5/25/2021,20PNR1GB,2021 NBA Playoffs - Round 1 - Home Game B,7,1050,880,-170,52:06.4,10
5/25/2021,20PNR1GB,2021 NBA Playoffs - Round 1 - Home Game B,7,880,870,-10,52:05.3,11
5/25/2021,20PNR1GB,2021 NBA Playoffs - Round 1 - Home Game B,8,18275,32420,14145,16:39.7,1
5/25/2021,20PNR1GB,2021 NBA Playoffs - Round 1 - Home Game B,8,32420,930,-31490,34:56.5,2
5/25/2021,20PNR1GB,2021 NBA Playoffs - Round 1 - Home Game B,8,930,1100,170,52:05.6,3
5/25/2021,20PNR1GB,2021 NBA Playoffs - Round 1 - Home Game B,8,1100,1230,130,52:12.9,4
5/25/2021,20PNR1GB,2021 NBA Playoffs - Round 1 - Home Game B,8,1230,1850,620,52:13.3,5
5/25/2021,20PNR1GB,2021 NBA Playoffs - Round 1 - Home Game B,8,1850,1650,-200,52:12.5,6
5/25/2021,20PNR1GB,2021 NBA Playoffs - Round 1 - Home Game B,8,1650,1480,-170,52:16.3,7
5/25/2021,20PNR1GB,2021 NBA Playoffs - Round 1 - Home Game B,8,1480,1440,-40,52:15.3,8
5/25/2021,20PNR1GB,2021 NBA Playoffs - Round 1 - Home Game B,8,1440,1230,-210,52:05.6,9
5/25/2021,20PNR1GB,2021 NBA Playoffs - Round 1 - Home Game B,8,1230,1120,-110,52:05.0,10
5/25/2021,20PNR1GB,2021 NBA Playoffs - Round 1 - Home Game B,8,1120,850,-270,52:05.1,11
5/25/2021,20PNR1GB,2021 NBA Playoffs - Round 1 - Home Game B,8,850,560,-290,52:06.4,12
5/25/2021,20PNR1GB,2021 NBA Playoffs - Round 1 - Home Game B,8,560,545,-15,52:05.3,13
5/25/2021,20PNR1GB,2021 NBA Playoffs - Round 1 - Home Game B,9,17630,31260,13630,16:39.8,1
5/25/2021,20PNR1GB,2021 NBA Playoffs - Round 1 - Home Game B,9,31260,895,-30365,34:56.5,2
5/25/2021,20PNR1GB,2021 NBA Playoffs - Round 1 - Home Game B,9,895,1100,205,52:05.6,3
5/25/2021,20PNR1GB,2021 NBA Playoffs - Round 1 - Home Game B,9,1100,1200,100,52:12.9,4
5/25/2021,20PNR1GB,2021 NBA Playoffs - Round 1 - Home Game B,9,1200,1800,600,52:13.3,5
5/25/2021,20PNR1GB,2021 NBA Playoffs - Round 1 - Home Game B,9,1800,1600,-200,52:12.5,6
5/25/2021,20PNR1GB,2021 NBA Playoffs - Round 1 - Home Game B,9,1600,1440,-160,52:16.3,7
5/25/2021,20PNR1GB,2021 NBA Playoffs - Round 1 - Home Game B,9,1440,1370,-70,52:15.3,8
5/25/2021,20PNR1GB,2021 NBA Playoffs - Round 1 - Home Game B,9,1370,1170,-200,52:05.6,9
5/25/2021,20PNR1GB,2021 NBA Playoffs - Round 1 - Home Game B,9,1170,1030,-140,52:05.0,10
5/25/2021,20PNR1GB,2021 NBA Playoffs - Round 1 - Home Game B,9,1030,780,-250,52:05.1,11
5/25/2021,20PNR1GB,2021 NBA Playoffs - Round 1 - Home Game B,9,780,540,-240,52:06.4,12
5/25/2021,20PNR1GB,2021 NBA Playoffs - Round 1 - Home Game B,9,540,525,-15,52:05.3,13
5/25/2021,20PNR1GB,2021 NBA Playoffs - Round 1 - Home Game B,A,0,16770,16770,32:43.5,1
5/25/2021,20PNR1GB,2021 NBA Playoffs - Round 1 - Home Game B,A,16770,29570,12800,16:39.9,2
5/25/2021,20PNR1GB,2021 NBA Playoffs - Round 1 - Home Game B,A,29570,845,-28725,34:56.5,3
5/25/2021,20PNR1GB,2021 NBA Playoffs - Round 1 - Home Game B,A,845,1500,655,52:05.6,4
5/25/2021,20PNR1GB,2021 NBA Playoffs - Round 1 - Home Game B,A,1500,965,-535,52:06.4,5
5/25/2021,20PNR1GB,2021 NBA Playoffs - Round 1 - Home Game B,A,965,1230,265,52:12.8,6
5/25/2021,20PNR1GB,2021 NBA Playoffs - Round 1 - Home Game B,A,1230,1130,-100,52:12.9,7
5/25/2021,20PNR1GB,2021 NBA Playoffs - Round 1 - Home Game B,A,1130,1700,570,52:13.3,8
5/25/2021,20PNR1GB,2021 NBA Playoffs - Round 1 - Home Game B,A,1700,1530,-170,52:12.5,9
5/25/2021,20PNR1GB,2021 NBA Playoffs - Round 1 - Home Game B,A,1530,1370,-160,52:16.3,10
5/25/2021,20PNR1GB,2021 NBA Playoffs - Round 1 - Home Game B,A,1370,1290,-80,52:15.3,11
5/25/2021,20PNR1GB,2021 NBA Playoffs - Round 1 - Home Game B,A,1290,1100,-190,52:05.6,12
5/25/2021,20PNR1GB,2021 NBA Playoffs - Round 1 - Home Game B,A,1100,950,-150,52:05.0,13
5/25/2021,20PNR1GB,2021 NBA Playoffs - Round 1 - Home Game B,A,950,725,-225,52:05.1,14
5/25/2021,20PNR1GB,2021 NBA Playoffs - Round 1 - Home Game B,A,725,525,-200,52:06.4,15
5/25/2021,20PNR1GB,2021 NBA Playoffs - Round 1 - Home Game B,A,525,500,-25,52:05.3,16
5/25/2021,20PNR1GB,2021 NBA Playoffs - Round 1 - Home Game B,B,0,16125,16125,32:43.6,1
5/25/2021,20PNR1GB,2021 NBA Playoffs - Round 1 - Home Game B,B,16125,26880,10755,16:40.0,2
5/25/2021,20PNR1GB,2021 NBA Playoffs - Round 1 - Home Game B,B,26880,770,-26110,34:56.5,3
5/25/2021,20PNR1GB,2021 NBA Playoffs - Round 1 - Home Game B,B,770,1100,330,52:05.6,4
5/25/2021,20PNR1GB,2021 NBA Playoffs - Round 1 - Home Game B,B,1100,940,-160,52:06.4,5
5/25/2021,20PNR1GB,2021 NBA Playoffs - Round 1 - Home Game B,B,940,1200,260,52:12.8,6
5/25/2021,20PNR1GB,2021 NBA Playoffs - Round 1 - Home Game B,B,1200,1030,-170,52:12.9,7
5/25/2021,20PNR1GB,2021 NBA Playoffs - Round 1 - Home Game B,B,1030,1550,520,52:13.3,8
5/25/2021,20PNR1GB,2021 NBA Playoffs - Round 1 - Home Game B,B,1550,1400,-150,52:12.5,9
5/25/2021,20PNR1GB,2021 NBA Playoffs - Round 1 - Home Game B,B,1400,1250,-150,52:16.3,10
5/25/2021,20PNR1GB,2021 NBA Playoffs - Round 1 - Home Game B,B,1250,1180,-70,52:15.3,11
5/25/2021,20PNR1GB,2021 NBA Playoffs - Round 1 - Home Game B,B,1180,1010,-170,52:05.6,12
5/25/2021,20PNR1GB,2021 NBA Playoffs - Round 1 - Home Game B,B,1010,735,-275,52:05.0,13
5/25/2021,20PNR1GB,2021 NBA Playoffs - Round 1 - Home Game B,B,735,570,-165,52:05.1,14
5/25/2021,20PNR1GB,2021 NBA Playoffs - Round 1 - Home Game B,B,570,475,-95,52:06.4,15
5/25/2021,20PNR1GB,2021 NBA Playoffs - Round 1 - Home Game B,B,475,450,-25,52:05.3,16
5/25/2021,20PNR1GB,2021 NBA Playoffs - Round 1 - Home Game B,C,0,15050,15050,32:43.7,1
5/25/2021,20PNR1GB,2021 NBA Playoffs - Round 1 - Home Game B,C,15050,24590,9540,16:40.1,2
5/25/2021,20PNR1GB,2021 NBA Playoffs - Round 1 - Home Game B,C,24590,705,-23885,34:56.5,3
5/25/2021,20PNR1GB,2021 NBA Playoffs - Round 1 - Home Game B,C,705,1100,395,52:05.6,4
5/25/2021,20PNR1GB,2021 NBA Playoffs - Round 1 - Home Game B,C,1100,890,-210,52:06.4,5
5/25/2021,20PNR1GB,2021 NBA Playoffs - Round 1 - Home Game B,C,890,1130,240,52:12.8,6
5/25/2021,20PNR1GB,2021 NBA Playoffs - Round 1 - Home Game B,C,1130,945,-185,52:12.9,7
5/25/2021,20PNR1GB,2021 NBA Playoffs - Round 1 - Home Game B,C,945,1420,475,52:13.3,8
5/25/2021,20PNR1GB,2021 NBA Playoffs - Round 1 - Home Game B,C,1420,1280,-140,52:12.5,9
5/25/2021,20PNR1GB,2021 NBA Playoffs - Round 1 - Home Game B,C,1280,1150,-130,52:16.3,10
5/25/2021,20PNR1GB,2021 NBA Playoffs - Round 1 - Home Game B,C,1150,1080,-70,52:15.3,11
5/25/2021,20PNR1GB,2021 NBA Playoffs - Round 1 - Home Game B,C,1080,920,-160,52:05.6,12
5/25/2021,20PNR1GB,2021 NBA Playoffs - Round 1 - Home Game B,C,920,690,-230,52:05.0,13
5/25/2021,20PNR1GB,2021 NBA Playoffs - Round 1 - Home Game B,C,690,525,-165,52:05.1,14
5/25/2021,20PNR1GB,2021 NBA Playoffs - Round 1 - Home Game B,C,525,435,-90,52:06.4,15
5/25/2021,20PNR1GB,2021 NBA Playoffs - Round 1 - Home Game B,C,435,420,-15,52:05.3,16
5/25/2021,20PNR1GB,2021 NBA Playoffs - Round 1 - Home Game B,D,0,14190,14190,32:43.8,1
5/25/2021,20PNR1GB,2021 NBA Playoffs - Round 1 - Home Game B,D,14190,23530,9340,16:40.2,2
5/25/2021,20PNR1GB,2021 NBA Playoffs - Round 1 - Home Game B,D,23530,675,-22855,34:56.5,3
5/25/2021,20PNR1GB,2021 NBA Playoffs - Round 1 - Home Game B,D,675,1500,825,52:05.6,4
5/25/2021,20PNR1GB,2021 NBA Playoffs - Round 1 - Home Game B,D,1500,805,-695,52:06.4,5
5/25/2021,20PNR1GB,2021 NBA Playoffs - Round 1 - Home Game B,D,805,1030,225,52:12.8,6
5/25/2021,20PNR1GB,2021 NBA Playoffs - Round 1 - Home Game B,D,1030,900,-130,52:12.9,7
5/25/2021,20PNR1GB,2021 NBA Playoffs - Round 1 - Home Game B,D,900,1350,450,52:13.3,8
5/25/2021,20PNR1GB,2021 NBA Playoffs - Round 1 - Home Game B,D,1350,1220,-130,52:12.5,9
5/25/2021,20PNR1GB,2021 NBA Playoffs - Round 1 - Home Game B,D,1220,1090,-130,52:16.3,10
5/25/2021,20PNR1GB,2021 NBA Playoffs - Round 1 - Home Game B,D,1090,1010,-80,52:15.3,11
5/25/2021,20PNR1GB,2021 NBA Playoffs - Round 1 - Home Game B,D,1010,760,-250,52:05.6,12
5/25/2021,20PNR1GB,2021 NBA Playoffs - Round 1 - Home Game B,D,760,655,-105,52:05.0,13
5/25/2021,20PNR1GB,2021 NBA Playoffs - Round 1 - Home Game B,D,655,500,-155,52:05.1,14
5/25/2021,20PNR1GB,2021 NBA Playoffs - Round 1 - Home Game B,D,500,415,-85,52:06.4,15
5/25/2021,20PNR1GB,2021 NBA Playoffs - Round 1 - Home Game B,D,415,400,-15,52:05.3,16
5/25/2021,20PNR1GB,2021 NBA Playoffs - Round 1 - Home Game B,E,0,13330,13330,32:43.9,1
5/25/2021,20PNR1GB,2021 NBA Playoffs - Round 1 - Home Game B,E,13330,19750,6420,16:40.4,2
5/25/2021,20PNR1GB,2021 NBA Playoffs - Round 1 - Home Game B,E,19750,565,-19185,34:56.5,3
5/25/2021,20PNR1GB,2021 NBA Playoffs - Round 1 - Home Game B,E,565,1100,535,52:05.6,4
5/25/2021,20PNR1GB,2021 NBA Playoffs - Round 1 - Home Game B,E,1100,740,-360,52:06.4,5
5/25/2021,20PNR1GB,2021 NBA Playoffs - Round 1 - Home Game B,E,740,945,205,52:12.8,6
5/25/2021,20PNR1GB,2021 NBA Playoffs - Round 1 - Home Game B,E,945,755,-190,52:12.9,7
5/25/2021,20PNR1GB,2021 NBA Playoffs - Round 1 - Home Game B,E,755,1140,385,52:13.3,8
5/25/2021,20PNR1GB,2021 NBA Playoffs - Round 1 - Home Game B,E,1140,1030,-110,52:12.5,9
5/25/2021,20PNR1GB,2021 NBA Playoffs - Round 1 - Home Game B,E,1030,925,-105,52:16.3,10
5/25/2021,20PNR1GB,2021 NBA Playoffs - Round 1 - Home Game B,E,925,860,-65,52:15.3,11
5/25/2021,20PNR1GB,2021 NBA Playoffs - Round 1 - Home Game B,E,860,730,-130,52:05.6,12
5/25/2021,20PNR1GB,2021 NBA Playoffs - Round 1 - Home Game B,E,730,550,-180,52:05.0,13
5/25/2021,20PNR1GB,2021 NBA Playoffs - Round 1 - Home Game B,E,550,420,-130,52:05.1,14
5/25/2021,20PNR1GB,2021 NBA Playoffs - Round 1 - Home Game B,E,420,350,-70,52:06.4,15
5/25/2021,20PNR1GB,2021 NBA Playoffs - Round 1 - Home Game B,E,350,335,-15,52:05.3,16
5/25/2021,20PNR1GB,2021 NBA Playoffs - Round 1 - Home Game B,F,0,11395,11395,32:44.0,1
5/25/2021,20PNR1GB,2021 NBA Playoffs - Round 1 - Home Game B,F,11395,18710,7315,16:40.4,2
5/25/2021,20PNR1GB,2021 NBA Playoffs - Round 1 - Home Game B,F,18710,535,-18175,34:56.5,3
5/25/2021,20PNR1GB,2021 NBA Playoffs - Round 1 - Home Game B,F,535,1100,565,52:05.6,4
5/25/2021,20PNR1GB,2021 NBA Playoffs - Round 1 - Home Game B,F,1100,705,-395,52:06.4,5
5/25/2021,20PNR1GB,2021 NBA Playoffs - Round 1 - Home Game B,F,705,900,195,52:12.8,6
5/25/2021,20PNR1GB,2021 NBA Playoffs - Round 1 - Home Game B,F,900,720,-180,52:12.9,7
5/25/2021,20PNR1GB,2021 NBA Playoffs - Round 1 - Home Game B,F,720,1080,360,52:13.3,8
5/25/2021,20PNR1GB,2021 NBA Playoffs - Round 1 - Home Game B,F,1080,975,-105,52:12.5,9
5/25/2021,20PNR1GB,2021 NBA Playoffs - Round 1 - Home Game B,F,975,875,-100,52:16.3,10
5/25/2021,20PNR1GB,2021 NBA Playoffs - Round 1 - Home Game B,F,875,810,-65,52:15.3,11
5/25/2021,20PNR1GB,2021 NBA Playoffs - Round 1 - Home Game B,F,810,690,-120,52:05.6,12
5/25/2021,20PNR1GB,2021 NBA Playoffs - Round 1 - Home Game B,F,690,530,-160,52:05.0,13
5/25/2021,20PNR1GB,2021 NBA Playoffs - Round 1 - Home Game B,F,530,405,-125,52:05.1,14
5/25/2021,20PNR1GB,2021 NBA Playoffs - Round 1 - Home Game B,F,405,335,-70,52:06.4,15
5/25/2021,20PNR1GB,2021 NBA Playoffs - Round 1 - Home Game B,F,335,320,-15,52:05.3,16
5/25/2021,20PNR1GB,2021 NBA Playoffs - Round 1 - Home Game B,G,0,10965,10965,32:44.1,1
5/25/2021,20PNR1GB,2021 NBA Playoffs - Round 1 - Home Game B,G,10965,17090,6125,16:40.6,2
5/25/2021,20PNR1GB,2021 NBA Playoffs - Round 1 - Home Game B,G,17090,490,-16600,34:56.5,3
5/25/2021,20PNR1GB,2021 NBA Playoffs - Round 1 - Home Game B,G,490,1100,610,52:05.6,4
5/25/2021,20PNR1GB,2021 NBA Playoffs - Round 1 - Home Game B,G,1100,590,-510,52:06.4,5
5/25/2021,20PNR1GB,2021 NBA Playoffs - Round 1 - Home Game B,G,590,755,165,52:12.8,6
5/25/2021,20PNR1GB,2021 NBA Playoffs - Round 1 - Home Game B,G,755,655,-100,52:12.9,7
5/25/2021,20PNR1GB,2021 NBA Playoffs - Round 1 - Home Game B,G,655,985,330,52:13.3,8
5/25/2021,20PNR1GB,2021 NBA Playoffs - Round 1 - Home Game B,G,985,885,-100,52:12.5,9
5/25/2021,20PNR1GB,2021 NBA Playoffs - Round 1 - Home Game B,G,885,795,-90,52:16.3,10
5/25/2021,20PNR1GB,2021 NBA Playoffs - Round 1 - Home Game B,G,795,740,-55,52:15.3,11
5/25/2021,20PNR1GB,2021 NBA Playoffs - Round 1 - Home Game B,G,740,630,-110,52:05.6,12
5/25/2021,20PNR1GB,2021 NBA Playoffs - Round 1 - Home Game B,G,630,490,-140,52:05.0,13
5/25/2021,20PNR1GB,2021 NBA Playoffs - Round 1 - Home Game B,G,490,375,-115,52:05.1,14
5/25/2021,20PNR1GB,2021 NBA Playoffs - Round 1 - Home Game B,G,375,310,-65,52:06.4,15
5/25/2021,20PNR1GB,2021 NBA Playoffs - Round 1 - Home Game B,G,310,295,-15,52:05.3,16
5/25/2021,20PNR1GB,2021 NBA Playoffs - Round 1 - Home Game B,H,0,10535,10535,32:44.2,1
5/25/2021,20PNR1GB,2021 NBA Playoffs - Round 1 - Home Game B,H,10535,15770,5235,16:40.7,2
5/25/2021,20PNR1GB,2021 NBA Playoffs - Round 1 - Home Game B,H,15770,450,-15320,34:56.5,3
5/25/2021,20PNR1GB,2021 NBA Playoffs - Round 1 - Home Game B,H,450,1100,650,52:05.6,4
5/25/2021,20PNR1GB,2021 NBA Playoffs - Round 1 - Home Game B,H,1100,560,-540,52:06.4,5
5/25/2021,20PNR1GB,2021 NBA Playoffs - Round 1 - Home Game B,H,560,720,160,52:12.8,6
5/25/2021,20PNR1GB,2021 NBA Playoffs - Round 1 - Home Game B,H,720,605,-115,52:12.9,7
5/25/2021,20PNR1GB,2021 NBA Playoffs - Round 1 - Home Game B,H,605,910,305,52:13.3,8
5/25/2021,20PNR1GB,2021 NBA Playoffs - Round 1 - Home Game B,H,910,820,-90,52:12.5,9
5/25/2021,20PNR1GB,2021 NBA Playoffs - Round 1 - Home Game B,H,820,735,-85,52:16.3,10
5/25/2021,20PNR1GB,2021 NBA Playoffs - Round 1 - Home Game B,H,735,685,-50,52:15.3,11
5/25/2021,20PNR1GB,2021 NBA Playoffs - Round 1 - Home Game B,H,685,580,-105,52:05.6,12
5/25/2021,20PNR1GB,2021 NBA Playoffs - Round 1 - Home Game B,H,580,450,-130,52:05.0,13
5/25/2021,20PNR1GB,2021 NBA Playoffs - Round 1 - Home Game B,H,450,345,-105,52:05.1,14
5/25/2021,20PNR1GB,2021 NBA Playoffs - Round 1 - Home Game B,H,345,285,-60,52:06.4,15
5/25/2021,20PNR1GB,2021 NBA Playoffs - Round 1 - Home Game B,H,285,270,-15,52:05.3,16
5/25/2021,20PNR1GB,2021 NBA Playoffs - Round 1 - Home Game B,I,0,9030,9030,32:44.3,1
5/25/2021,20PNR1GB,2021 NBA Playoffs - Round 1 - Home Game B,I,9030,14180,5150,16:40.8,2
5/25/2021,20PNR1GB,2021 NBA Playoffs - Round 1 - Home Game B,I,14180,405,-13775,34:56.5,3
5/25/2021,20PNR1GB,2021 NBA Playoffs - Round 1 - Home Game B,I,405,1100,695,52:05.6,4
5/25/2021,20PNR1GB,2021 NBA Playoffs - Round 1 - Home Game B,I,1100,515,-585,52:06.4,5
5/25/2021,20PNR1GB,2021 NBA Playoffs - Round 1 - Home Game B,I,515,655,140,52:12.8,6
5/25/2021,20PNR1GB,2021 NBA Playoffs - Round 1 - Home Game B,I,655,545,-110,52:12.9,7
5/25/2021,20PNR1GB,2021 NBA Playoffs - Round 1 - Home Game B,I,545,820,275,52:13.3,8
5/25/2021,20PNR1GB,2021 NBA Playoffs - Round 1 - Home Game B,I,820,740,-80,52:12.5,9
5/25/2021,20PNR1GB,2021 NBA Playoffs - Round 1 - Home Game B,I,740,665,-75,52:16.3,10
5/25/2021,20PNR1GB,2021 NBA Playoffs - Round 1 - Home Game B,I,665,610,-55,52:15.3,11
5/25/2021,20PNR1GB,2021 NBA Playoffs - Round 1 - Home Game B,I,610,520,-90,52:05.6,12
5/25/2021,20PNR1GB,2021 NBA Playoffs - Round 1 - Home Game B,I,520,415,-105,52:05.0,13
5/25/2021,20PNR1GB,2021 NBA Playoffs - Round 1 - Home Game B,I,415,315,-100,52:05.1,14
5/25/2021,20PNR1GB,2021 NBA Playoffs - Round 1 - Home Game B,I,315,265,-50,52:06.4,15
5/25/2021,20PNR1GB,2021 NBA Playoffs - Round 1 - Home Game B,I,265,250,-15,52:05.3,16
5/25/2021,20PNR1GB,2021 NBA Playoffs - Round 1 - Home Game B,J,0,8385,8385,32:44.4,1
5/25/2021,20PNR1GB,2021 NBA Playoffs - Round 1 - Home Game B,J,8385,13080,4695,16:40.9,2
5/25/2021,20PNR1GB,2021 NBA Playoffs - Round 1 - Home Game B,J,13080,375,-12705,34:56.5,3
5/25/2021,20PNR1GB,2021 NBA Playoffs - Round 1 - Home Game B,J,375,1500,1125,52:05.6,4
5/25/2021,20PNR1GB,2021 NBA Playoffs - Round 1 - Home Game B,J,1500,475,-1025,52:06.4,5
5/25/2021,20PNR1GB,2021 NBA Playoffs - Round 1 - Home Game B,J,475,605,130,52:12.8,6
5/25/2021,20PNR1GB,2021 NBA Playoffs - Round 1 - Home Game B,J,605,500,-105,52:12.9,7
5/25/2021,20PNR1GB,2021 NBA Playoffs - Round 1 - Home Game B,J,500,750,250,52:13.3,8
5/25/2021,20PNR1GB,2021 NBA Playoffs - Round 1 - Home Game B,J,750,675,-75,52:12.5,9
5/25/2021,20PNR1GB,2021 NBA Playoffs - Round 1 - Home Game B,J,675,600,-75,52:16.3,10
5/25/2021,20PNR1GB,2021 NBA Playoffs - Round 1 - Home Game B,J,600,560,-40,52:15.3,11
5/25/2021,20PNR1GB,2021 NBA Playoffs - Round 1 - Home Game B,J,560,475,-85,52:05.6,12
5/25/2021,20PNR1GB,2021 NBA Playoffs - Round 1 - Home Game B,J,475,390,-85,52:05.0,13
5/25/2021,20PNR1GB,2021 NBA Playoffs - Round 1 - Home Game B,J,390,295,-95,52:05.1,14
5/25/2021,20PNR1GB,2021 NBA Playoffs - Round 1 - Home Game B,J,295,250,-45,52:06.4,15
5/25/2021,20PNR1GB,2021 NBA Playoffs - Round 1 - Home Game B,J,250,235,-15,52:05.3,16
5/25/2021,20PNR1GB,2021 NBA Playoffs - Round 1 - Home Game B,K,0,6880,6880,32:44.5,1
5/25/2021,20PNR1GB,2021 NBA Playoffs - Round 1 - Home Game B,K,6880,12160,5280,16:40.9,2
5/25/2021,20PNR1GB,2021 NBA Playoffs - Round 1 - Home Game B,K,12160,350,-11810,34:56.5,3
5/25/2021,20PNR1GB,2021 NBA Playoffs - Round 1 - Home Game B,K,350,1100,750,52:05.6,4
5/25/2021,20PNR1GB,2021 NBA Playoffs - Round 1 - Home Game B,K,1100,425,-675,52:06.4,5
5/25/2021,20PNR1GB,2021 NBA Playoffs - Round 1 - Home Game B,K,425,545,120,52:12.8,6
5/25/2021,20PNR1GB,2021 NBA Playoffs - Round 1 - Home Game B,K,545,465,-80,52:12.9,7
5/25/2021,20PNR1GB,2021 NBA Playoffs - Round 1 - Home Game B,K,465,700,235,52:13.3,8
5/25/2021,20PNR1GB,2021 NBA Playoffs - Round 1 - Home Game B,K,700,630,-70,52:12.5,9
5/25/2021,20PNR1GB,2021 NBA Playoffs - Round 1 - Home Game B,K,630,565,-65,52:16.3,10
5/25/2021,20PNR1GB,2021 NBA Playoffs - Round 1 - Home Game B,K,565,535,-30,52:15.3,11
5/25/2021,20PNR1GB,2021 NBA Playoffs - Round 1 - Home Game B,K,535,455,-80,52:05.6,12
5/25/2021,20PNR1GB,2021 NBA Playoffs - Round 1 - Home Game B,K,455,370,-85,52:05.0,13
5/25/2021,20PNR1GB,2021 NBA Playoffs - Round 1 - Home Game B,K,370,280,-90,52:05.1,14
5/25/2021,20PNR1GB,2021 NBA Playoffs - Round 1 - Home Game B,K,280,235,-45,52:06.4,15
5/25/2021,20PNR1GB,2021 NBA Playoffs - Round 1 - Home Game B,K,235,220,-15,52:05.3,16
5/25/2021,20PNR1GB,2021 NBA Playoffs - Round 1 - Home Game B,L,0,6450,6450,32:44.6,1
5/25/2021,20PNR1GB,2021 NBA Playoffs - Round 1 - Home Game B,L,6450,11930,5480,16:41.1,2
5/25/2021,20PNR1GB,2021 NBA Playoffs - Round 1 - Home Game B,L,11930,340,-11590,34:56.5,3
5/25/2021,20PNR1GB,2021 NBA Playoffs - Round 1 - Home Game B,L,340,1100,760,52:05.6,4
5/25/2021,20PNR1GB,2021 NBA Playoffs - Round 1 - Home Game B,L,1100,395,-705,52:06.4,5
5/25/2021,20PNR1GB,2021 NBA Playoffs - Round 1 - Home Game B,L,395,500,105,52:12.8,6
5/25/2021,20PNR1GB,2021 NBA Playoffs - Round 1 - Home Game B,L,500,455,-45,52:12.9,7
5/25/2021,20PNR1GB,2021 NBA Playoffs - Round 1 - Home Game B,L,455,685,230,52:13.3,8
5/25/2021,20PNR1GB,2021 NBA Playoffs - Round 1 - Home Game B,L,685,615,-70,52:12.5,9
5/25/2021,20PNR1GB,2021 NBA Playoffs - Round 1 - Home Game B,L,615,550,-65,52:16.3,10
5/25/2021,20PNR1GB,2021 NBA Playoffs - Round 1 - Home Game B,L,550,520,-30,52:15.3,11
5/25/2021,20PNR1GB,2021 NBA Playoffs - Round 1 - Home Game B,L,520,440,-80,52:05.6,12
5/25/2021,20PNR1GB,2021 NBA Playoffs - Round 1 - Home Game B,L,440,360,-80,52:05.0,13
5/25/2021,20PNR1GB,2021 NBA Playoffs - Round 1 - Home Game B,L,360,275,-85,52:05.1,14
5/25/2021,20PNR1GB,2021 NBA Playoffs - Round 1 - Home Game B,L,275,230,-45,52:06.4,15
5/25/2021,20PNR1GB,2021 NBA Playoffs - Round 1 - Home Game B,L,230,210,-20,52:05.3,16
5/25/2021,20PNR1GB,2021 NBA Playoffs - Round 1 - Home Game B,M,0,6020,6020,32:44.7,1
5/25/2021,20PNR1GB,2021 NBA Playoffs - Round 1 - Home Game B,M,6020,10470,4450,16:41.1,2
5/25/2021,20PNR1GB,2021 NBA Playoffs - Round 1 - Home Game B,M,10470,300,-10170,34:56.5,3
5/25/2021,20PNR1GB,2021 NBA Playoffs - Round 1 - Home Game B,M,300,1100,800,52:05.6,4
5/25/2021,20PNR1GB,2021 NBA Playoffs - Round 1 - Home Game B,M,1100,365,-735,52:06.4,5
5/25/2021,20PNR1GB,2021 NBA Playoffs - Round 1 - Home Game B,M,365,465,100,52:12.8,6
5/25/2021,20PNR1GB,2021 NBA Playoffs - Round 1 - Home Game B,M,465,400,-65,52:12.9,7
5/25/2021,20PNR1GB,2021 NBA Playoffs - Round 1 - Home Game B,M,400,600,200,52:13.3,8
5/25/2021,20PNR1GB,2021 NBA Playoffs - Round 1 - Home Game B,M,600,540,-60,52:12.5,9
5/25/2021,20PNR1GB,2021 NBA Playoffs - Round 1 - Home Game B,M,540,455,-85,52:16.3,10
5/25/2021,20PNR1GB,2021 NBA Playoffs - Round 1 - Home Game B,M,455,385,-70,52:05.6,11
5/25/2021,20PNR1GB,2021 NBA Playoffs - Round 1 - Home Game B,M,385,320,-65,52:05.0,12
5/25/2021,20PNR1GB,2021 NBA Playoffs - Round 1 - Home Game B,M,320,240,-80,52:05.1,13
5/25/2021,20PNR1GB,2021 NBA Playoffs - Round 1 - Home Game B,M,240,205,-35,52:06.4,14
5/25/2021,20PNR1GB,2021 NBA Playoffs - Round 1 - Home Game B,N,0,10105,10105,32:44.8,1
5/25/2021,20PNR1GB,2021 NBA Playoffs - Round 1 - Home Game B,N,10105,17290,7185,16:41.2,2
5/25/2021,20PNR1GB,2021 NBA Playoffs - Round 1 - Home Game B,N,17290,495,-16795,34:56.5,3
5/25/2021,20PNR1GB,2021 NBA Playoffs - Round 1 - Home Game B,N,495,1100,605,52:05.6,4
5/25/2021,20PNR1GB,2021 NBA Playoffs - Round 1 - Home Game B,N,1100,360,-740,52:06.4,5
5/25/2021,20PNR1GB,2021 NBA Playoffs - Round 1 - Home Game B,N,360,455,95,52:12.8,6
5/25/2021,20PNR1GB,2021 NBA Playoffs - Round 1 - Home Game B,N,455,665,210,52:12.9,7
5/25/2021,20PNR1GB,2021 NBA Playoffs - Round 1 - Home Game B,N,665,1000,335,52:13.3,8
5/25/2021,20PNR1GB,2021 NBA Playoffs - Round 1 - Home Game B,N,1000,900,-100,52:12.5,9
5/25/2021,20PNR1GB,2021 NBA Playoffs - Round 1 - Home Game B,N,900,810,-90,52:16.3,10
5/25/2021,20PNR1GB,2021 NBA Playoffs - Round 1 - Home Game B,N,810,745,-65,52:15.3,11
5/25/2021,20PNR1GB,2021 NBA Playoffs - Round 1 - Home Game B,N,745,635,-110,52:05.6,12
5/25/2021,20PNR1GB,2021 NBA Playoffs - Round 1 - Home Game B,N,635,510,-125,52:05.0,13
5/25/2021,20PNR1GB,2021 NBA Playoffs - Round 1 - Home Game B,N,510,385,-125,52:05.1,14
5/25/2021,20PNR1GB,2021 NBA Playoffs - Round 1 - Home Game B,N,385,325,-60,52:06.4,15
5/25/2021,20PNR1GB,2021 NBA Playoffs - Round 1 - Home Game B,N,325,310,-15,52:05.3,16
5/25/2021,20PNR1GB,2021 NBA Playoffs - Round 1 - Home Game B,O,0,9460,9460,32:44.9,1
5/25/2021,20PNR1GB,2021 NBA Playoffs - Round 1 - Home Game B,O,9460,15550,6090,16:41.3,2
5/25/2021,20PNR1GB,2021 NBA Playoffs - Round 1 - Home Game B,O,15550,445,-15105,34:56.5,3
5/25/2021,20PNR1GB,2021 NBA Playoffs - Round 1 - Home Game B,O,445,1500,1055,52:05.6,4
5/25/2021,20PNR1GB,2021 NBA Playoffs - Round 1 - Home Game B,O,1500,315,-1185,52:06.4,5
5/25/2021,20PNR1GB,2021 NBA Playoffs - Round 1 - Home Game B,O,315,400,85,52:12.8,6
5/25/2021,20PNR1GB,2021 NBA Playoffs - Round 1 - Home Game B,O,400,595,195,52:12.9,7
5/25/2021,20PNR1GB,2021 NBA Playoffs - Round 1 - Home Game B,O,595,895,300,52:13.3,8
5/25/2021,20PNR1GB,2021 NBA Playoffs - Round 1 - Home Game B,O,895,805,-90,52:12.5,9
5/25/2021,20PNR1GB,2021 NBA Playoffs - Round 1 - Home Game B,O,805,720,-85,52:16.3,10
5/25/2021,20PNR1GB,2021 NBA Playoffs - Round 1 - Home Game B,O,720,675,-45,52:15.3,11
5/25/2021,20PNR1GB,2021 NBA Playoffs - Round 1 - Home Game B,O,675,575,-100,52:05.6,12
5/25/2021,20PNR1GB,2021 NBA Playoffs - Round 1 - Home Game B,O,575,440,-135,52:05.0,13
5/25/2021,20PNR1GB,2021 NBA Playoffs - Round 1 - Home Game B,O,440,340,-100,52:05.1,14
5/25/2021,20PNR1GB,2021 NBA Playoffs - Round 1 - Home Game B,O,340,290,-50,52:06.4,15
5/25/2021,20PNR1GB,2021 NBA Playoffs - Round 1 - Home Game B,O,290,275,-15,52:05.3,16
5/25/2021,20PNR1GB,2021 NBA Playoffs - Round 1 - Home Game B,P,0,7740,7740,32:45.0,1
5/25/2021,20PNR1GB,2021 NBA Playoffs - Round 1 - Home Game B,P,7740,13670,5930,16:41.4,2
5/25/2021,20PNR1GB,2021 NBA Playoffs - Round 1 - Home Game B,P,13670,390,-13280,34:56.5,3
5/25/2021,20PNR1GB,2021 NBA Playoffs - Round 1 - Home Game B,P,390,1100,710,52:05.6,4
5/25/2021,20PNR1GB,2021 NBA Playoffs - Round 1 - Home Game B,P,1100,520,-580,52:06.4,5
5/25/2021,20PNR1GB,2021 NBA Playoffs - Round 1 - Home Game B,P,520,665,145,52:12.8,6
5/25/2021,20PNR1GB,2021 NBA Playoffs - Round 1 - Home Game B,P,665,525,-140,52:12.9,7
5/25/2021,20PNR1GB,2021 NBA Playoffs - Round 1 - Home Game B,P,525,790,265,52:13.3,8
5/25/2021,20PNR1GB,2021 NBA Playoffs - Round 1 - Home Game B,P,790,710,-80,52:12.5,9
5/25/2021,20PNR1GB,2021 NBA Playoffs - Round 1 - Home Game B,P,710,635,-75,52:16.3,10
5/25/2021,20PNR1GB,2021 NBA Playoffs - Round 1 - Home Game B,P,635,590,-45,52:15.3,11
5/25/2021,20PNR1GB,2021 NBA Playoffs - Round 1 - Home Game B,P,590,500,-90,52:05.6,12
5/25/2021,20PNR1GB,2021 NBA Playoffs - Round 1 - Home Game B,P,500,410,-90,52:05.0,13
5/25/2021,20PNR1GB,2021 NBA Playoffs - Round 1 - Home Game B,P,410,310,-100,52:05.1,14
5/25/2021,20PNR1GB,2021 NBA Playoffs - Round 1 - Home Game B,P,310,260,-50,52:06.4,15
5/25/2021,20PNR1GB,2021 NBA Playoffs - Round 1 - Home Game B,P,260,245,-15,52:05.3,16
5/25/2021,20PNR1GB,2021 NBA Playoffs - Round 1 - Home Game B,Q,0,6880,6880,32:45.1,1
5/25/2021,20PNR1GB,2021 NBA Playoffs - Round 1 - Home Game B,Q,6880,10960,4080,16:41.5,2
5/25/2021,20PNR1GB,2021 NBA Playoffs - Round 1 - Home Game B,Q,10960,315,-10645,34:56.5,3
5/25/2021,20PNR1GB,2021 NBA Playoffs - Round 1 - Home Game B,Q,315,1100,785,52:05.6,4
5/25/2021,20PNR1GB,2021 NBA Playoffs - Round 1 - Home Game B,Q,1100,465,-635,52:06.4,5
5/25/2021,20PNR1GB,2021 NBA Playoffs - Round 1 - Home Game B,Q,465,595,130,52:12.8,6
5/25/2021,20PNR1GB,2021 NBA Playoffs - Round 1 - Home Game B,Q,595,420,-175,52:12.9,7
5/25/2021,20PNR1GB,2021 NBA Playoffs - Round 1 - Home Game B,Q,420,630,210,52:13.3,8
5/25/2021,20PNR1GB,2021 NBA Playoffs - Round 1 - Home Game B,Q,630,570,-60,52:12.5,9
5/25/2021,20PNR1GB,2021 NBA Playoffs - Round 1 - Home Game B,Q,570,510,-60,52:16.3,10
5/25/2021,20PNR1GB,2021 NBA Playoffs - Round 1 - Home Game B,Q,510,480,-30,52:15.3,11
5/25/2021,20PNR1GB,2021 NBA Playoffs - Round 1 - Home Game B,Q,480,410,-70,52:05.6,12
5/25/2021,20PNR1GB,2021 NBA Playoffs - Round 1 - Home Game B,Q,410,335,-75,52:05.0,13
5/25/2021,20PNR1GB,2021 NBA Playoffs - Round 1 - Home Game B,Q,335,260,-75,52:05.1,14
5/25/2021,20PNR1GB,2021 NBA Playoffs - Round 1 - Home Game B,Q,260,215,-45,52:06.4,15
5/25/2021,20PNR1GB,2021 NBA Playoffs - Round 1 - Home Game B,Q,215,200,-15,52:05.3,16
5/25/2021,20PNR1GB,2021 NBA Playoffs - Round 1 - Home Game B,R,0,5590,5590,32:45.2,1
5/25/2021,20PNR1GB,2021 NBA Playoffs - Round 1 - Home Game B,R,5590,9740,4150,16:41.6,2
5/25/2021,20PNR1GB,2021 NBA Playoffs - Round 1 - Home Game B,R,9740,280,-9460,34:56.5,3
5/25/2021,20PNR1GB,2021 NBA Playoffs - Round 1 - Home Game B,R,280,1100,820,52:05.6,4
5/25/2021,20PNR1GB,2021 NBA Playoffs - Round 1 - Home Game B,R,1100,410,-690,52:06.4,5
5/25/2021,20PNR1GB,2021 NBA Playoffs - Round 1 - Home Game B,R,410,525,115,52:12.8,6
5/25/2021,20PNR1GB,2021 NBA Playoffs - Round 1 - Home Game B,R,525,375,-150,52:12.9,7
5/25/2021,20PNR1GB,2021 NBA Playoffs - Round 1 - Home Game B,R,375,565,190,52:13.3,8
5/25/2021,20PNR1GB,2021 NBA Playoffs - Round 1 - Home Game B,R,565,505,-60,52:12.5,9
5/25/2021,20PNR1GB,2021 NBA Playoffs - Round 1 - Home Game B,R,505,455,-50,52:16.3,10
5/25/2021,20PNR1GB,2021 NBA Playoffs - Round 1 - Home Game B,R,455,435,-20,52:15.3,11
5/25/2021,20PNR1GB,2021 NBA Playoffs - Round 1 - Home Game B,R,435,370,-65,52:05.6,12
5/25/2021,20PNR1GB,2021 NBA Playoffs - Round 1 - Home Game B,R,370,295,-75,52:05.0,13
5/25/2021,20PNR1GB,2021 NBA Playoffs - Round 1 - Home Game B,R,295,235,-60,52:05.1,14
5/25/2021,20PNR1GB,2021 NBA Playoffs - Round 1 - Home Game B,R,235,190,-45,52:06.4,15
5/25/2021,20PNR1GB,2021 NBA Playoffs - Round 1 - Home Game B,S,0,5590,5590,32:45.3,1
5/25/2021,20PNR1GB,2021 NBA Playoffs - Round 1 - Home Game B,S,5590,9740,4150,16:41.7,2
5/25/2021,20PNR1GB,2021 NBA Playoffs - Round 1 - Home Game B,S,9740,280,-9460,34:56.5,3
5/25/2021,20PNR1GB,2021 NBA Playoffs - Round 1 - Home Game B,S,280,1100,820,52:05.6,4
5/25/2021,20PNR1GB,2021 NBA Playoffs - Round 1 - Home Game B,S,1100,330,-770,52:06.4,5
5/25/2021,20PNR1GB,2021 NBA Playoffs - Round 1 - Home Game B,S,330,420,90,52:12.8,6
5/25/2021,20PNR1GB,2021 NBA Playoffs - Round 1 - Home Game B,S,420,375,-45,52:12.9,7
5/25/2021,20PNR1GB,2021 NBA Playoffs - Round 1 - Home Game B,S,375,565,190,52:13.3,8
5/25/2021,20PNR1GB,2021 NBA Playoffs - Round 1 - Home Game B,S,565,505,-60,52:12.5,9
5/25/2021,20PNR1GB,2021 NBA Playoffs - Round 1 - Home Game B,S,505,455,-50,52:16.3,10
5/25/2021,20PNR1GB,2021 NBA Playoffs - Round 1 - Home Game B,S,455,435,-20,52:15.3,11
5/25/2021,20PNR1GB,2021 NBA Playoffs - Round 1 - Home Game B,S,435,370,-65,52:05.6,12
5/25/2021,20PNR1GB,2021 NBA Playoffs - Round 1 - Home Game B,S,370,305,-65,52:05.0,13
5/25/2021,20PNR1GB,2021 NBA Playoffs - Round 1 - Home Game B,S,305,235,-70,52:05.1,14
5/25/2021,20PNR1GB,2021 NBA Playoffs - Round 1 - Home Game B,S,235,190,-45,52:06.4,15
5/25/2021,20PNR1GB,2021 NBA Playoffs - Round 1 - Home Game B,T,0,4730,4730,32:45.4,1
5/25/2021,20PNR1GB,2021 NBA Playoffs - Round 1 - Home Game B,T,4730,8030,3300,16:41.8,2
5/25/2021,20PNR1GB,2021 NBA Playoffs - Round 1 - Home Game B,T,8030,230,-7800,34:56.5,3
5/25/2021,20PNR1GB,2021 NBA Playoffs - Round 1 - Home Game B,T,230,1100,870,52:05.6,4
5/25/2021,20PNR1GB,2021 NBA Playoffs - Round 1 - Home Game B,T,1100,295,-805,52:06.4,5
5/25/2021,20PNR1GB,2021 NBA Playoffs - Round 1 - Home Game B,T,295,375,80,52:12.8,6
5/25/2021,20PNR1GB,2021 NBA Playoffs - Round 1 - Home Game B,T,375,305,-70,52:12.9,7
5/25/2021,20PNR1GB,2021 NBA Playoffs - Round 1 - Home Game B,T,305,460,155,52:13.3,8
5/25/2021,20PNR1GB,2021 NBA Playoffs - Round 1 - Home Game B,T,460,415,-45,52:12.5,9
5/25/2021,20PNR1GB,2021 NBA Playoffs - Round 1 - Home Game B,T,415,370,-45,52:16.3,10
5/25/2021,20PNR1GB,2021 NBA Playoffs - Round 1 - Home Game B,T,370,350,-20,52:15.3,11
5/25/2021,20PNR1GB,2021 NBA Playoffs - Round 1 - Home Game B,T,350,300,-50,52:05.6,12
5/25/2021,20PNR1GB,2021 NBA Playoffs - Round 1 - Home Game B,T,300,255,-45,52:05.0,13
5/25/2021,20PNR1GB,2021 NBA Playoffs - Round 1 - Home Game B,T,255,195,-60,52:05.1,14
5/25/2021,20PNR1GB,2021 NBA Playoffs - Round 1 - Home Game B,T,195,180,-15,52:06.4,15
5/25/2021,20PNR1GB,2021 NBA Playoffs - Round 1 - Home Game B,U,0,3870,3870,32:45.5,1
5/25/2021,20PNR1GB,2021 NBA Playoffs - Round 1 - Home Game B,U,3870,7130,3260,16:41.9,2
5/25/2021,20PNR1GB,2021 NBA Playoffs - Round 1 - Home Game B,U,7130,205,-6925,34:56.5,3
5/25/2021,20PNR1GB,2021 NBA Playoffs - Round 1 - Home Game B,U,205,1100,895,52:05.6,4
5/25/2021,20PNR1GB,2021 NBA Playoffs - Round 1 - Home Game B,U,1100,295,-805,52:06.4,5
5/25/2021,20PNR1GB,2021 NBA Playoffs - Round 1 - Home Game B,U,295,375,80,52:12.8,6
5/25/2021,20PNR1GB,2021 NBA Playoffs - Round 1 - Home Game B,U,375,275,-100,52:12.9,7
5/25/2021,20PNR1GB,2021 NBA Playoffs - Round 1 - Home Game B,U,275,415,140,52:13.3,8
5/25/2021,20PNR1GB,2021 NBA Playoffs - Round 1 - Home Game B,U,415,375,-40,52:12.5,9
5/25/2021,20PNR1GB,2021 NBA Playoffs - Round 1 - Home Game B,U,375,335,-40,52:16.3,10
5/25/2021,20PNR1GB,2021 NBA Playoffs - Round 1 - Home Game B,U,335,320,-15,52:15.3,11
5/25/2021,20PNR1GB,2021 NBA Playoffs - Round 1 - Home Game B,U,320,270,-50,52:05.6,12
5/25/2021,20PNR1GB,2021 NBA Playoffs - Round 1 - Home Game B,U,270,230,-40,52:05.0,13
5/25/2021,20PNR1GB,2021 NBA Playoffs - Round 1 - Home Game B,U,230,195,-35,52:05.1,14
5/25/2021,20PNR1GB,2021 NBA Playoffs - Round 1 - Home Game B,U,195,175,-20,52:06.4,15
5/25/2021,20PNR1GB,2021 NBA Playoffs - Round 1 - Home Game B,U,175,165,-10,52:05.3,16
5/25/2021,20PNR1GB,2021 NBA Playoffs - Round 1 - Home Game B,V,0,3440,3440,32:45.6,1
5/25/2021,20PNR1GB,2021 NBA Playoffs - Round 1 - Home Game B,V,3440,6430,2990,16:42.0,2
5/25/2021,20PNR1GB,2021 NBA Playoffs - Round 1 - Home Game B,V,6430,185,-6245,34:56.5,3
5/25/2021,20PNR1GB,2021 NBA Playoffs - Round 1 - Home Game B,V,185,1100,915,52:05.6,4
5/25/2021,20PNR1GB,2021 NBA Playoffs - Round 1 - Home Game B,V,1100,240,-860,52:06.4,5
5/25/2021,20PNR1GB,2021 NBA Playoffs - Round 1 - Home Game B,V,240,305,65,52:12.8,6
5/25/2021,20PNR1GB,2021 NBA Playoffs - Round 1 - Home Game B,V,305,245,-60,52:12.9,7
5/25/2021,20PNR1GB,2021 NBA Playoffs - Round 1 - Home Game B,V,245,370,125,52:13.3,8
5/25/2021,20PNR1GB,2021 NBA Playoffs - Round 1 - Home Game B,V,370,330,-40,52:12.5,9
5/25/2021,20PNR1GB,2021 NBA Playoffs - Round 1 - Home Game B,V,330,295,-35,52:16.3,10
5/25/2021,20PNR1GB,2021 NBA Playoffs - Round 1 - Home Game B,V,295,275,-20,52:15.3,11
5/25/2021,20PNR1GB,2021 NBA Playoffs - Round 1 - Home Game B,V,275,235,-40,52:05.6,12
5/25/2021,20PNR1GB,2021 NBA Playoffs - Round 1 - Home Game B,V,235,210,-25,52:05.0,13
5/25/2021,20PNR1GB,2021 NBA Playoffs - Round 1 - Home Game B,V,210,185,-25,52:05.1,14
5/25/2021,20PNR1GB,2021 NBA Playoffs - Round 1 - Home Game B,V,185,165,-20,52:06.4,15
5/25/2021,20PNR1GB,2021 NBA Playoffs - Round 1 - Home Game B,V,165,150,-15,52:05.3,16
5/25/2021,20PNR1GB,2021 NBA Playoffs - Round 1 - Home Game B,W,0,3010,3010,32:45.6,1
5/25/2021,20PNR1GB,2021 NBA Playoffs - Round 1 - Home Game B,W,3010,6030,3020,16:42.1,2
5/25/2021,20PNR1GB,2021 NBA Playoffs - Round 1 - Home Game B,W,6030,175,-5855,34:56.5,3
5/25/2021,20PNR1GB,2021 NBA Playoffs - Round 1 - Home Game B,W,175,1100,925,52:05.6,4
5/25/2021,20PNR1GB,2021 NBA Playoffs - Round 1 - Home Game B,W,1100,215,-885,52:06.4,5
5/25/2021,20PNR1GB,2021 NBA Playoffs - Round 1 - Home Game B,W,215,275,60,52:12.8,6
5/25/2021,20PNR1GB,2021 NBA Playoffs - Round 1 - Home Game B,W,275,230,-45,52:12.9,7
5/25/2021,20PNR1GB,2021 NBA Playoffs - Round 1 - Home Game B,W,230,345,115,52:13.3,8
5/25/2021,20PNR1GB,2021 NBA Playoffs - Round 1 - Home Game B,W,345,310,-35,52:12.5,9
5/25/2021,20PNR1GB,2021 NBA Playoffs - Round 1 - Home Game B,W,310,275,-35,52:16.3,10
5/25/2021,20PNR1GB,2021 NBA Playoffs - Round 1 - Home Game B,W,275,269,-6,52:15.3,11
5/25/2021,20PNR1GB,2021 NBA Playoffs - Round 1 - Home Game B,W,269,230,-39,52:05.6,12
5/25/2021,20PNR1GB,2021 NBA Playoffs - Round 1 - Home Game B,W,230,190,-40,52:05.0,13
5/25/2021,20PNR1GB,2021 NBA Playoffs - Round 1 - Home Game B,W,190,165,-25,52:05.1,14
5/25/2021,20PNR1GB,2021 NBA Playoffs - Round 1 - Home Game B,W,165,160,-5,52:06.4,15
5/25/2021,20PNR1GB,2021 NBA Playoffs - Round 1 - Home Game B,W,160,140,-20,52:05.3,16
5/25/2021,20PNR1GB,2021 NBA Playoffs - Round 1 - Home Game B,X,0,2795,2795,32:45.7,1
5/25/2021,20PNR1GB,2021 NBA Playoffs - Round 1 - Home Game B,X,2795,5370,2575,16:42.2,2
5/25/2021,20PNR1GB,2021 NBA Playoffs - Round 1 - Home Game B,X,5370,155,-5215,34:56.5,3
5/25/2021,20PNR1GB,2021 NBA Playoffs - Round 1 - Home Game B,X,155,1100,945,52:05.6,4
5/25/2021,20PNR1GB,2021 NBA Playoffs - Round 1 - Home Game B,X,1100,605,-495,52:06.4,5
5/25/2021,20PNR1GB,2021 NBA Playoffs - Round 1 - Home Game B,X,605,775,170,52:12.8,6
5/25/2021,20PNR1GB,2021 NBA Playoffs - Round 1 - Home Game B,X,775,205,-570,52:12.9,7
5/25/2021,20PNR1GB,2021 NBA Playoffs - Round 1 - Home Game B,X,205,310,105,52:13.3,8
5/25/2021,20PNR1GB,2021 NBA Playoffs - Round 1 - Home Game B,X,310,280,-30,52:12.5,9
5/25/2021,20PNR1GB,2021 NBA Playoffs - Round 1 - Home Game B,X,280,245,-35,52:16.3,10
5/25/2021,20PNR1GB,2021 NBA Playoffs - Round 1 - Home Game B,X,245,210,-35,52:05.6,11
5/25/2021,20PNR1GB,2021 NBA Playoffs - Round 1 - Home Game B,X,210,175,-35,52:05.0,12
5/25/2021,20PNR1GB,2021 NBA Playoffs - Round 1 - Home Game B,X,175,150,-25,52:05.1,13
5/25/2021,20PNR1GB,2021 NBA Playoffs - Round 1 - Home Game B,X,150,130,-20,52:05.3,14
5/25/2021,20PNR1GB,2021 NBA Playoffs - Round 1 - Home Game B,Y,0,2795,2795,32:45.8,1
5/25/2021,20PNR1GB,2021 NBA Playoffs - Round 1 - Home Game B,Y,2795,5220,2425,16:42.2,2
5/25/2021,20PNR1GB,2021 NBA Playoffs - Round 1 - Home Game B,Y,5220,150,-5070,34:56.5,3
5/25/2021,20PNR1GB,2021 NBA Playoffs - Round 1 - Home Game B,Y,150,1100,950,52:05.6,4
5/25/2021,20PNR1GB,2021 NBA Playoffs - Round 1 - Home Game B,Y,1100,200,-900,52:12.9,5
5/25/2021,20PNR1GB,2021 NBA Playoffs - Round 1 - Home Game B,Y,200,300,100,52:13.3,6
5/25/2021,20PNR1GB,2021 NBA Playoffs - Round 1 - Home Game B,Y,300,270,-30,52:12.5,7
5/25/2021,20PNR1GB,2021 NBA Playoffs - Round 1 - Home Game B,Y,270,240,-30,52:16.3,8
5/25/2021,20PNR1GB,2021 NBA Playoffs - Round 1 - Home Game B,Y,240,235,-5,52:15.3,9
5/25/2021,20PNR1GB,2021 NBA Playoffs - Round 1 - Home Game B,Y,235,200,-35,52:05.6,10
5/25/2021,20PNR1GB,2021 NBA Playoffs - Round 1 - Home Game B,Y,200,160,-40,52:05.0,11
5/25/2021,20PNR1GB,2021 NBA Playoffs - Round 1 - Home Game B,Y,160,130,-30,52:05.1,12
5/25/2021,20PNR1GB,2021 NBA Playoffs - Round 1 - Home Game B,Y,130,120,-10,52:05.3,13
5/25/2021,20PNR1GB,2021 NBA Playoffs - Round 1 - Home Game B,Z,0,999999,999999,32:45.9,1
5/25/2021,20PNR1GB,2021 NBA Playoffs - Round 1 - Home Game B,Z,999999,20190,-979809,16:42.3,2
5/25/2021,20PNR1GB,2021 NBA Playoffs - Round 1 - Home Game B,Z,20190,580,-19610,34:56.5,3
5/25/2021,20PNR1GB,2021 NBA Playoffs - Round 1 - Home Game B,Z,580,1100,520,52:05.6,4
5/25/2021,20PNR1GB,2021 NBA Playoffs - Round 1 - Home Game B,Z,1100,775,-325,52:12.9,5
5/25/2021,20PNR1GB,2021 NBA Playoffs - Round 1 - Home Game B,Z,775,1170,395,52:13.3,6
5/25/2021,20PNR1GB,2021 NBA Playoffs - Round 1 - Home Game B,Z,1170,1050,-120,52:12.5,7
5/25/2021,20PNR1GB,2021 NBA Playoffs - Round 1 - Home Game B,Z,1050,945,-105,52:16.3,8
5/25/2021,20PNR1GB,2021 NBA Playoffs - Round 1 - Home Game B,Z,945,860,-85,52:15.3,9
5/25/2021,20PNR1GB,2021 NBA Playoffs - Round 1 - Home Game B,Z,860,730,-130,52:05.6,10
5/25/2021,20PNR1GB,2021 NBA Playoffs - Round 1 - Home Game B,Z,730,545,-185,52:05.0,11
5/25/2021,20PNR1VB,2021 NBA Playoffs - Round 1 - Home Game B,1,0,6050,6050,12:50.8,1
5/25/2021,20PNR1VB,2021 NBA Playoffs - Round 1 - Home Game B,1,6050,1100,-4950,52:11.0,2
5/25/2021,20PNR1VB,2021 NBA Playoffs - Round 1 - Home Game B,1,1100,6000,4900,52:16.1,3
5/25/2021,20PNR1VB,2021 NBA Playoffs - Round 1 - Home Game B,2,0,6050,6050,12:50.9,1
5/25/2021,20PNR1VB,2021 NBA Playoffs - Round 1 - Home Game B,2,6050,1100,-4950,52:11.0,2
5/25/2021,20PNR1VB,2021 NBA Playoffs - Round 1 - Home Game B,2,1100,6000,4900,52:16.1,3
5/25/2021,20PNR1VB,2021 NBA Playoffs - Round 1 - Home Game B,3,0,6050,6050,12:51.0,1
5/25/2021,20PNR1VB,2021 NBA Playoffs - Round 1 - Home Game B,3,6050,1100,-4950,52:11.0,2
5/25/2021,20PNR1VB,2021 NBA Playoffs - Round 1 - Home Game B,3,1100,6000,4900,52:16.1,3
5/25/2021,20PNR1VB,2021 NBA Playoffs - Round 1 - Home Game B,4,0,4400,4400,12:51.1,1
5/25/2021,20PNR1VB,2021 NBA Playoffs - Round 1 - Home Game B,4,4400,1100,-3300,52:11.0,2
5/25/2021,20PNR1VB,2021 NBA Playoffs - Round 1 - Home Game B,4,1100,6000,4900,52:16.1,3
5/25/2021,20PNR1VB,2021 NBA Playoffs - Round 1 - Home Game B,5,0,1820,1820,12:51.2,1
5/25/2021,20PNR1VB,2021 NBA Playoffs - Round 1 - Home Game B,5,1820,1100,-720,52:11.0,2
5/25/2021,20PNR1VB,2021 NBA Playoffs - Round 1 - Home Game B,5,1100,1110,10,52:16.1,3
5/25/2021,20PNR1VB,2021 NBA Playoffs - Round 1 - Home Game B,5,1110,1200,90,52:05.0,4
5/25/2021,20PNR1VB,2021 NBA Playoffs - Round 1 - Home Game B,5,1200,1100,-100,52:05.4,5
5/25/2021,20PNR1VB,2021 NBA Playoffs - Round 1 - Home Game B,5,1100,1110,10,52:05.4,6
5/25/2021,20PNR1VB,2021 NBA Playoffs - Round 1 - Home Game B,5,1110,1100,-10,52:12.9,7
5/25/2021,20PNR1VB,2021 NBA Playoffs - Round 1 - Home Game B,5,1100,1110,10,52:05.8,8
5/25/2021,20PNR1VB,2021 NBA Playoffs - Round 1 - Home Game B,6,0,1360,1360,12:51.3,1
5/25/2021,20PNR1VB,2021 NBA Playoffs - Round 1 - Home Game B,6,1360,1100,-260,52:11.0,2
5/25/2021,20PNR1VB,2021 NBA Playoffs - Round 1 - Home Game B,6,1100,870,-230,52:16.1,3
5/25/2021,20PNR1VB,2021 NBA Playoffs - Round 1 - Home Game B,6,870,920,50,53:01.8,4
5/25/2021,20PNR1VB,2021 NBA Playoffs - Round 1 - Home Game B,6,920,965,45,52:11.8,5
5/25/2021,20PNR1VB,2021 NBA Playoffs - Round 1 - Home Game B,6,965,1040,75,52:05.0,6
5/25/2021,20PNR1VB,2021 NBA Playoffs - Round 1 - Home Game B,6,1040,935,-105,52:05.4,7
5/25/2021,20PNR1VB,2021 NBA Playoffs - Round 1 - Home Game B,6,935,920,-15,52:12.9,8
5/25/2021,20PNR1VB,2021 NBA Playoffs - Round 1 - Home Game B,7,1325,1100,-225,52:11.0,1
5/25/2021,20PNR1VB,2021 NBA Playoffs - Round 1 - Home Game B,7,1100,870,-230,53:01.8,2
5/25/2021,20PNR1VB,2021 NBA Playoffs - Round 1 - Home Game B,7,870,915,45,52:11.8,3
5/25/2021,20PNR1VB,2021 NBA Playoffs - Round 1 - Home Game B,7,915,990,75,52:05.0,4
5/25/2021,20PNR1VB,2021 NBA Playoffs - Round 1 - Home Game B,7,990,890,-100,52:05.4,5
5/25/2021,20PNR1VB,2021 NBA Playoffs - Round 1 - Home Game B,7,890,870,-20,52:12.9,6
5/25/2021,20PNR1VB,2021 NBA Playoffs - Round 1 - Home Game B,8,930,1100,170,52:11.0,1
5/25/2021,20PNR1VB,2021 NBA Playoffs - Round 1 - Home Game B,8,1100,700,-400,52:38.5,2
5/25/2021,20PNR1VB,2021 NBA Playoffs - Round 1 - Home Game B,8,700,735,35,52:11.8,3
5/25/2021,20PNR1VB,2021 NBA Playoffs - Round 1 - Home Game B,8,735,795,60,52:05.0,4
5/25/2021,20PNR1VB,2021 NBA Playoffs - Round 1 - Home Game B,8,795,715,-80,52:05.4,5
5/25/2021,20PNR1VB,2021 NBA Playoffs - Round 1 - Home Game B,8,715,550,-165,52:12.9,6
5/25/2021,20PNR1VB,2021 NBA Playoffs - Round 1 - Home Game B,8,550,545,-5,52:12.6,7
5/25/2021,20PNR1VB,2021 NBA Playoffs - Round 1 - Home Game B,9,895,1100,205,52:11.0,1
5/25/2021,20PNR1VB,2021 NBA Playoffs - Round 1 - Home Game B,9,1100,640,-460,52:38.5,2
5/25/2021,20PNR1VB,2021 NBA Playoffs - Round 1 - Home Game B,9,640,670,30,52:11.8,3
5/25/2021,20PNR1VB,2021 NBA Playoffs - Round 1 - Home Game B,9,670,725,55,52:05.0,4
5/25/2021,20PNR1VB,2021 NBA Playoffs - Round 1 - Home Game B,9,725,650,-75,52:05.4,5
5/25/2021,20PNR1VB,2021 NBA Playoffs - Round 1 - Home Game B,9,650,535,-115,52:12.9,6
5/25/2021,20PNR1VB,2021 NBA Playoffs - Round 1 - Home Game B,9,535,525,-10,52:12.6,7
5/25/2021,20PNR1VB,2021 NBA Playoffs - Round 1 - Home Game B,A,0,845,845,12:51.4,1
5/25/2021,20PNR1VB,2021 NBA Playoffs - Round 1 - Home Game B,A,845,1100,255,52:11.0,2
5/25/2021,20PNR1VB,2021 NBA Playoffs - Round 1 - Home Game B,A,1100,965,-135,52:28.5,3
5/25/2021,20PNR1VB,2021 NBA Playoffs - Round 1 - Home Game B,A,965,580,-385,52:11.2,4
5/25/2021,20PNR1VB,2021 NBA Playoffs - Round 1 - Home Game B,A,580,700,120,52:31.6,5
5/25/2021,20PNR1VB,2021 NBA Playoffs - Round 1 - Home Game B,A,700,610,-90,52:38.5,6
5/25/2021,20PNR1VB,2021 NBA Playoffs - Round 1 - Home Game B,A,610,595,-15,52:21.2,7
5/25/2021,20PNR1VB,2021 NBA Playoffs - Round 1 - Home Game B,A,595,625,30,52:11.8,8
5/25/2021,20PNR1VB,2021 NBA Playoffs - Round 1 - Home Game B,A,625,675,50,52:05.0,9
5/25/2021,20PNR1VB,2021 NBA Playoffs - Round 1 - Home Game B,A,675,605,-70,52:05.4,10
5/25/2021,20PNR1VB,2021 NBA Playoffs - Round 1 - Home Game B,A,605,505,-100,52:12.9,11
5/25/2021,20PNR1VB,2021 NBA Playoffs - Round 1 - Home Game B,A,505,500,-5,52:12.6,12
5/25/2021,20PNR1VB,2021 NBA Playoffs - Round 1 - Home Game B,B,0,770,770,12:51.5,1
5/25/2021,20PNR1VB,2021 NBA Playoffs - Round 1 - Home Game B,B,770,1100,330,52:11.0,2
5/25/2021,20PNR1VB,2021 NBA Playoffs - Round 1 - Home Game B,B,1100,940,-160,52:28.5,3
5/25/2021,20PNR1VB,2021 NBA Playoffs - Round 1 - Home Game B,B,940,560,-380,52:11.2,4
5/25/2021,20PNR1VB,2021 NBA Playoffs - Round 1 - Home Game B,B,560,640,80,52:31.6,5
5/25/2021,20PNR1VB,2021 NBA Playoffs - Round 1 - Home Game B,B,640,550,-90,52:38.5,6
5/25/2021,20PNR1VB,2021 NBA Playoffs - Round 1 - Home Game B,B,550,460,-90,52:27.3,7
5/25/2021,20PNR1VB,2021 NBA Playoffs - Round 1 - Home Game B,B,460,485,25,52:11.8,8
5/25/2021,20PNR1VB,2021 NBA Playoffs - Round 1 - Home Game B,B,485,525,40,52:05.0,9
5/25/2021,20PNR1VB,2021 NBA Playoffs - Round 1 - Home Game B,B,525,470,-55,52:05.4,10
5/25/2021,20PNR1VB,2021 NBA Playoffs - Round 1 - Home Game B,B,470,450,-20,52:12.9,11
5/25/2021,20PNR1VB,2021 NBA Playoffs - Round 1 - Home Game B,C,0,705,705,12:51.6,1
5/25/2021,20PNR1VB,2021 NBA Playoffs - Round 1 - Home Game B,C,705,1500,795,52:11.0,2
5/25/2021,20PNR1VB,2021 NBA Playoffs - Round 1 - Home Game B,C,1500,890,-610,52:28.5,3
5/25/2021,20PNR1VB,2021 NBA Playoffs - Round 1 - Home Game B,C,890,530,-360,52:11.2,4
5/25/2021,20PNR1VB,2021 NBA Playoffs - Round 1 - Home Game B,C,530,610,80,52:31.6,5
5/25/2021,20PNR1VB,2021 NBA Playoffs - Round 1 - Home Game B,C,610,515,-95,52:38.5,6
5/25/2021,20PNR1VB,2021 NBA Playoffs - Round 1 - Home Game B,C,515,440,-75,52:21.2,7
5/25/2021,20PNR1VB,2021 NBA Playoffs - Round 1 - Home Game B,C,440,430,-10,52:27.3,8
5/25/2021,20PNR1VB,2021 NBA Playoffs - Round 1 - Home Game B,C,430,450,20,52:11.8,9
5/25/2021,20PNR1VB,2021 NBA Playoffs - Round 1 - Home Game B,C,450,485,35,52:05.0,10
5/25/2021,20PNR1VB,2021 NBA Playoffs - Round 1 - Home Game B,C,485,435,-50,52:05.4,11
5/25/2021,20PNR1VB,2021 NBA Playoffs - Round 1 - Home Game B,C,435,420,-15,52:12.9,12
5/25/2021,20PNR1VB,2021 NBA Playoffs - Round 1 - Home Game B,D,0,675,675,12:51.7,1
5/25/2021,20PNR1VB,2021 NBA Playoffs - Round 1 - Home Game B,D,675,1100,425,52:11.0,2
5/25/2021,20PNR1VB,2021 NBA Playoffs - Round 1 - Home Game B,D,1100,805,-295,52:28.5,3
5/25/2021,20PNR1VB,2021 NBA Playoffs - Round 1 - Home Game B,D,805,480,-325,52:11.2,4
5/25/2021,20PNR1VB,2021 NBA Playoffs - Round 1 - Home Game B,D,480,550,70,52:31.6,5
5/25/2021,20PNR1VB,2021 NBA Playoffs - Round 1 - Home Game B,D,550,490,-60,52:38.5,6
5/25/2021,20PNR1VB,2021 NBA Playoffs - Round 1 - Home Game B,D,490,420,-70,52:21.2,7
5/25/2021,20PNR1VB,2021 NBA Playoffs - Round 1 - Home Game B,D,420,410,-10,52:27.3,8
5/25/2021,20PNR1VB,2021 NBA Playoffs - Round 1 - Home Game B,D,410,430,20,52:11.8,9
5/25/2021,20PNR1VB,2021 NBA Playoffs - Round 1 - Home Game B,D,430,465,35,52:05.0,10
5/25/2021,20PNR1VB,2021 NBA Playoffs - Round 1 - Home Game B,D,465,415,-50,52:05.4,11
5/25/2021,20PNR1VB,2021 NBA Playoffs - Round 1 - Home Game B,D,415,400,-15,52:12.9,12
5/25/2021,20PNR1VB,2021 NBA Playoffs - Round 1 - Home Game B,E,0,565,565,12:51.8,1
5/25/2021,20PNR1VB,2021 NBA Playoffs - Round 1 - Home Game B,E,565,1100,535,52:11.0,2
5/25/2021,20PNR1VB,2021 NBA Playoffs - Round 1 - Home Game B,E,1100,740,-360,52:28.5,3
5/25/2021,20PNR1VB,2021 NBA Playoffs - Round 1 - Home Game B,E,740,445,-295,52:11.2,4
5/25/2021,20PNR1VB,2021 NBA Playoffs - Round 1 - Home Game B,E,445,515,70,52:31.6,5
5/25/2021,20PNR1VB,2021 NBA Playoffs - Round 1 - Home Game B,E,515,425,-90,52:38.5,6
5/25/2021,20PNR1VB,2021 NBA Playoffs - Round 1 - Home Game B,E,425,350,-75,52:21.2,7
5/25/2021,20PNR1VB,2021 NBA Playoffs - Round 1 - Home Game B,E,350,345,-5,52:27.3,8
5/25/2021,20PNR1VB,2021 NBA Playoffs - Round 1 - Home Game B,E,345,360,15,52:11.8,9
5/25/2021,20PNR1VB,2021 NBA Playoffs - Round 1 - Home Game B,E,360,390,30,52:05.0,10
5/25/2021,20PNR1VB,2021 NBA Playoffs - Round 1 - Home Game B,E,390,350,-40,52:05.4,11
5/25/2021,20PNR1VB,2021 NBA Playoffs - Round 1 - Home Game B,E,350,335,-15,52:12.9,12
5/25/2021,20PNR1VB,2021 NBA Playoffs - Round 1 - Home Game B,F,0,535,535,12:51.9,1
5/25/2021,20PNR1VB,2021 NBA Playoffs - Round 1 - Home Game B,F,535,1500,965,52:11.0,2
5/25/2021,20PNR1VB,2021 NBA Playoffs - Round 1 - Home Game B,F,1500,705,-795,52:28.5,3
5/25/2021,20PNR1VB,2021 NBA Playoffs - Round 1 - Home Game B,F,705,425,-280,52:11.2,4
5/25/2021,20PNR1VB,2021 NBA Playoffs - Round 1 - Home Game B,F,425,490,65,52:31.6,5
5/25/2021,20PNR1VB,2021 NBA Playoffs - Round 1 - Home Game B,F,490,395,-95,52:38.5,6
5/25/2021,20PNR1VB,2021 NBA Playoffs - Round 1 - Home Game B,F,395,340,-55,52:21.2,7
5/25/2021,20PNR1VB,2021 NBA Playoffs - Round 1 - Home Game B,F,340,330,-10,52:27.3,8
5/25/2021,20PNR1VB,2021 NBA Playoffs - Round 1 - Home Game B,F,330,345,15,52:11.8,9
5/25/2021,20PNR1VB,2021 NBA Playoffs - Round 1 - Home Game B,F,345,375,30,52:05.0,10
5/25/2021,20PNR1VB,2021 NBA Playoffs - Round 1 - Home Game B,F,375,335,-40,52:05.4,11
5/25/2021,20PNR1VB,2021 NBA Playoffs - Round 1 - Home Game B,F,335,320,-15,52:12.9,12
5/25/2021,20PNR1VB,2021 NBA Playoffs - Round 1 - Home Game B,G,0,490,490,12:52.1,1
5/25/2021,20PNR1VB,2021 NBA Playoffs - Round 1 - Home Game B,G,490,1100,610,52:11.0,2
5/25/2021,20PNR1VB,2021 NBA Playoffs - Round 1 - Home Game B,G,1100,590,-510,52:28.5,3
5/25/2021,20PNR1VB,2021 NBA Playoffs - Round 1 - Home Game B,G,590,360,-230,52:11.2,4
5/25/2021,20PNR1VB,2021 NBA Playoffs - Round 1 - Home Game B,G,360,425,65,52:31.6,5
5/25/2021,20PNR1VB,2021 NBA Playoffs - Round 1 - Home Game B,G,425,360,-65,52:38.5,6
5/25/2021,20PNR1VB,2021 NBA Playoffs - Round 1 - Home Game B,G,360,310,-50,52:21.2,7
5/25/2021,20PNR1VB,2021 NBA Playoffs - Round 1 - Home Game B,G,310,325,15,52:11.8,8
5/25/2021,20PNR1VB,2021 NBA Playoffs - Round 1 - Home Game B,G,325,350,25,52:05.0,9
5/25/2021,20PNR1VB,2021 NBA Playoffs - Round 1 - Home Game B,G,350,315,-35,52:05.4,10
5/25/2021,20PNR1VB,2021 NBA Playoffs - Round 1 - Home Game B,G,315,295,-20,52:12.9,11
5/25/2021,20PNR1VB,2021 NBA Playoffs - Round 1 - Home Game B,H,0,450,450,12:52.2,1
5/25/2021,20PNR1VB,2021 NBA Playoffs - Round 1 - Home Game B,H,450,1100,650,52:11.0,2
5/25/2021,20PNR1VB,2021 NBA Playoffs - Round 1 - Home Game B,H,1100,560,-540,52:28.5,3
5/25/2021,20PNR1VB,2021 NBA Playoffs - Round 1 - Home Game B,H,560,340,-220,52:11.2,4
5/25/2021,20PNR1VB,2021 NBA Playoffs - Round 1 - Home Game B,H,340,395,55,52:31.6,5
5/25/2021,20PNR1VB,2021 NBA Playoffs - Round 1 - Home Game B,H,395,330,-65,52:38.5,6
5/25/2021,20PNR1VB,2021 NBA Playoffs - Round 1 - Home Game B,H,330,295,-35,52:21.2,7
5/25/2021,20PNR1VB,2021 NBA Playoffs - Round 1 - Home Game B,H,295,280,-15,52:27.3,8
5/25/2021,20PNR1VB,2021 NBA Playoffs - Round 1 - Home Game B,H,280,295,15,52:11.8,9
5/25/2021,20PNR1VB,2021 NBA Playoffs - Round 1 - Home Game B,H,295,320,25,52:05.0,10
5/25/2021,20PNR1VB,2021 NBA Playoffs - Round 1 - Home Game B,H,320,285,-35,52:05.4,11
5/25/2021,20PNR1VB,2021 NBA Playoffs - Round 1 - Home Game B,H,285,270,-15,52:12.9,12
5/25/2021,20PNR1VB,2021 NBA Playoffs - Round 1 - Home Game B,I,0,405,405,12:52.2,1
5/25/2021,20PNR1VB,2021 NBA Playoffs - Round 1 - Home Game B,I,405,1100,695,52:11.0,2
5/25/2021,20PNR1VB,2021 NBA Playoffs - Round 1 - Home Game B,I,1100,515,-585,52:28.5,3
5/25/2021,20PNR1VB,2021 NBA Playoffs - Round 1 - Home Game B,I,515,315,-200,52:11.2,4
5/25/2021,20PNR1VB,2021 NBA Playoffs - Round 1 - Home Game B,I,315,360,45,52:31.6,5
5/25/2021,20PNR1VB,2021 NBA Playoffs - Round 1 - Home Game B,I,360,299,-61,52:38.5,6
5/25/2021,20PNR1VB,2021 NBA Playoffs - Round 1 - Home Game B,I,299,270,-29,52:21.2,7
5/25/2021,20PNR1VB,2021 NBA Playoffs - Round 1 - Home Game B,I,270,260,-10,52:27.3,8
5/25/2021,20PNR1VB,2021 NBA Playoffs - Round 1 - Home Game B,I,260,275,15,52:11.8,9
5/25/2021,20PNR1VB,2021 NBA Playoffs - Round 1 - Home Game B,I,275,295,20,52:05.0,10
5/25/2021,20PNR1VB,2021 NBA Playoffs - Round 1 - Home Game B,I,295,265,-30,52:05.4,11
5/25/2021,20PNR1VB,2021 NBA Playoffs - Round 1 - Home Game B,I,265,250,-15,52:12.9,12
5/25/2021,20PNR1VB,2021 NBA Playoffs - Round 1 - Home Game B,J,0,375,375,12:52.3,1
5/25/2021,20PNR1VB,2021 NBA Playoffs - Round 1 - Home Game B,J,375,1100,725,52:11.0,2
5/25/2021,20PNR1VB,2021 NBA Playoffs - Round 1 - Home Game B,J,1100,475,-625,52:28.5,3
5/25/2021,20PNR1VB,2021 NBA Playoffs - Round 1 - Home Game B,J,475,290,-185,52:11.2,4
5/25/2021,20PNR1VB,2021 NBA Playoffs - Round 1 - Home Game B,J,290,330,40,52:31.6,5
5/25/2021,20PNR1VB,2021 NBA Playoffs - Round 1 - Home Game B,J,330,275,-55,52:38.5,6
5/25/2021,20PNR1VB,2021 NBA Playoffs - Round 1 - Home Game B,J,275,255,-20,52:21.2,7
5/25/2021,20PNR1VB,2021 NBA Playoffs - Round 1 - Home Game B,J,255,245,-10,52:27.3,8
5/25/2021,20PNR1VB,2021 NBA Playoffs - Round 1 - Home Game B,J,245,255,10,52:11.8,9
5/25/2021,20PNR1VB,2021 NBA Playoffs - Round 1 - Home Game B,J,255,275,20,52:05.0,10
5/25/2021,20PNR1VB,2021 NBA Playoffs - Round 1 - Home Game B,J,275,245,-30,52:05.4,11
5/25/2021,20PNR1VB,2021 NBA Playoffs - Round 1 - Home Game B,J,245,235,-10,52:12.9,12
5/25/2021,20PNR1VB,2021 NBA Playoffs - Round 1 - Home Game B,K,0,350,350,12:52.4,1
5/25/2021,20PNR1VB,2021 NBA Playoffs - Round 1 - Home Game B,K,350,1500,1150,52:11.0,2
5/25/2021,20PNR1VB,2021 NBA Playoffs - Round 1 - Home Game B,K,1500,425,-1075,52:28.5,3
5/25/2021,20PNR1VB,2021 NBA Playoffs - Round 1 - Home Game B,K,425,265,-160,52:11.2,4
5/25/2021,20PNR1VB,2021 NBA Playoffs - Round 1 - Home Game B,K,265,299,34,52:31.6,5
5/25/2021,20PNR1VB,2021 NBA Playoffs - Round 1 - Home Game B,K,299,250,-49,52:38.5,6
5/25/2021,20PNR1VB,2021 NBA Playoffs - Round 1 - Home Game B,K,250,240,-10,52:21.2,7
5/25/2021,20PNR1VB,2021 NBA Playoffs - Round 1 - Home Game B,K,240,230,-10,52:27.3,8
5/25/2021,20PNR1VB,2021 NBA Playoffs - Round 1 - Home Game B,K,230,240,10,52:11.8,9
5/25/2021,20PNR1VB,2021 NBA Playoffs - Round 1 - Home Game B,K,240,260,20,52:05.0,10
5/25/2021,20PNR1VB,2021 NBA Playoffs - Round 1 - Home Game B,K,260,235,-25,52:05.4,11
5/25/2021,20PNR1VB,2021 NBA Playoffs - Round 1 - Home Game B,K,235,220,-15,52:12.9,12
5/25/2021,20PNR1VB,2021 NBA Playoffs - Round 1 - Home Game B,L,0,340,340,12:52.5,1
5/25/2021,20PNR1VB,2021 NBA Playoffs - Round 1 - Home Game B,L,340,1100,760,52:11.0,2
5/25/2021,20PNR1VB,2021 NBA Playoffs - Round 1 - Home Game B,L,1100,395,-705,52:28.5,3
5/25/2021,20PNR1VB,2021 NBA Playoffs - Round 1 - Home Game B,L,395,245,-150,52:11.2,4
5/25/2021,20PNR1VB,2021 NBA Playoffs - Round 1 - Home Game B,L,245,275,30,52:31.6,5
5/25/2021,20PNR1VB,2021 NBA Playoffs - Round 1 - Home Game B,L,275,240,-35,52:38.5,6
5/25/2021,20PNR1VB,2021 NBA Playoffs - Round 1 - Home Game B,L,240,235,-5,52:21.2,7
5/25/2021,20PNR1VB,2021 NBA Playoffs - Round 1 - Home Game B,L,235,225,-10,52:27.3,8
5/25/2021,20PNR1VB,2021 NBA Playoffs - Round 1 - Home Game B,L,225,235,10,52:11.8,9
5/25/2021,20PNR1VB,2021 NBA Playoffs - Round 1 - Home Game B,L,235,255,20,52:05.0,10
5/25/2021,20PNR1VB,2021 NBA Playoffs - Round 1 - Home Game B,L,255,225,-30,52:05.4,11
5/25/2021,20PNR1VB,2021 NBA Playoffs - Round 1 - Home Game B,L,225,215,-10,52:12.9,12
5/25/2021,20PNR1VB,2021 NBA Playoffs - Round 1 - Home Game B,M,0,300,300,12:52.6,1
5/25/2021,20PNR1VB,2021 NBA Playoffs - Round 1 - Home Game B,M,300,1100,800,52:11.0,2
5/25/2021,20PNR1VB,2021 NBA Playoffs - Round 1 - Home Game B,M,1100,365,-735,52:28.5,3
5/25/2021,20PNR1VB,2021 NBA Playoffs - Round 1 - Home Game B,M,365,230,-135,52:11.2,4
5/25/2021,20PNR1VB,2021 NBA Playoffs - Round 1 - Home Game B,M,230,250,20,52:31.6,5
5/25/2021,20PNR1VB,2021 NBA Playoffs - Round 1 - Home Game B,M,250,220,-30,52:38.5,6
5/25/2021,20PNR1VB,2021 NBA Playoffs - Round 1 - Home Game B,M,220,200,-20,52:27.3,7
5/25/2021,20PNR1VB,2021 NBA Playoffs - Round 1 - Home Game B,M,200,210,10,52:11.8,8
5/25/2021,20PNR1VB,2021 NBA Playoffs - Round 1 - Home Game B,M,210,225,15,52:05.0,9
5/25/2021,20PNR1VB,2021 NBA Playoffs - Round 1 - Home Game B,M,225,205,-20,52:05.4,10
5/25/2021,20PNR1VB,2021 NBA Playoffs - Round 1 - Home Game B,M,205,190,-15,52:12.9,11
5/25/2021,20PNR1VB,2021 NBA Playoffs - Round 1 - Home Game B,M,190,205,15,52:19.5,12
5/25/2021,20PNR1VB,2021 NBA Playoffs - Round 1 - Home Game B,M,205,190,-15,52:06.7,13
5/25/2021,20PNR1VB,2021 NBA Playoffs - Round 1 - Home Game B,N,0,495,495,12:52.7,1
5/25/2021,20PNR1VB,2021 NBA Playoffs - Round 1 - Home Game B,N,495,1100,605,52:11.0,2
5/25/2021,20PNR1VB,2021 NBA Playoffs - Round 1 - Home Game B,N,1100,360,-740,52:28.5,3
5/25/2021,20PNR1VB,2021 NBA Playoffs - Round 1 - Home Game B,N,360,225,-135,52:11.2,4
5/25/2021,20PNR1VB,2021 NBA Playoffs - Round 1 - Home Game B,N,225,240,15,52:31.6,5
5/25/2021,20PNR1VB,2021 NBA Playoffs - Round 1 - Home Game B,N,240,375,135,52:38.5,6
5/25/2021,20PNR1VB,2021 NBA Playoffs - Round 1 - Home Game B,N,375,330,-45,52:21.2,7
5/25/2021,20PNR1VB,2021 NBA Playoffs - Round 1 - Home Game B,N,330,320,-10,52:27.3,8
5/25/2021,20PNR1VB,2021 NBA Playoffs - Round 1 - Home Game B,N,320,335,15,52:11.8,9
5/25/2021,20PNR1VB,2021 NBA Playoffs - Round 1 - Home Game B,N,335,360,25,52:05.0,10
5/25/2021,20PNR1VB,2021 NBA Playoffs - Round 1 - Home Game B,N,360,310,-50,52:05.4,11
5/25/2021,20PNR1VB,2021 NBA Playoffs - Round 1 - Home Game B,O,0,445,445,12:52.8,1
5/25/2021,20PNR1VB,2021 NBA Playoffs - Round 1 - Home Game B,O,445,1100,655,52:11.0,2
5/25/2021,20PNR1VB,2021 NBA Playoffs - Round 1 - Home Game B,O,1100,315,-785,52:28.5,3
5/25/2021,20PNR1VB,2021 NBA Playoffs - Round 1 - Home Game B,O,315,200,-115,52:11.2,4
5/25/2021,20PNR1VB,2021 NBA Playoffs - Round 1 - Home Game B,O,200,220,20,52:31.6,5
5/25/2021,20PNR1VB,2021 NBA Playoffs - Round 1 - Home Game B,O,220,345,125,52:38.5,6
5/25/2021,20PNR1VB,2021 NBA Playoffs - Round 1 - Home Game B,O,345,275,-70,52:21.2,7
5/25/2021,20PNR1VB,2021 NBA Playoffs - Round 1 - Home Game B,O,275,290,15,52:11.8,8
5/25/2021,20PNR1VB,2021 NBA Playoffs - Round 1 - Home Game B,O,290,315,25,52:05.0,9
5/25/2021,20PNR1VB,2021 NBA Playoffs - Round 1 - Home Game B,O,315,280,-35,52:05.4,10
5/25/2021,20PNR1VB,2021 NBA Playoffs - Round 1 - Home Game B,O,280,275,-5,52:12.9,11
5/25/2021,20PNR1VB,2021 NBA Playoffs - Round 1 - Home Game B,P,0,390,390,12:52.9,1
5/25/2021,20PNR1VB,2021 NBA Playoffs - Round 1 - Home Game B,P,390,1100,710,52:11.0,2
5/25/2021,20PNR1VB,2021 NBA Playoffs - Round 1 - Home Game B,P,1100,520,-580,52:28.5,3
5/25/2021,20PNR1VB,2021 NBA Playoffs - Round 1 - Home Game B,P,520,330,-190,52:11.2,4
5/25/2021,20PNR1VB,2021 NBA Playoffs - Round 1 - Home Game B,P,330,375,45,52:31.6,5
5/25/2021,20PNR1VB,2021 NBA Playoffs - Round 1 - Home Game B,P,375,285,-90,52:38.5,6
5/25/2021,20PNR1VB,2021 NBA Playoffs - Round 1 - Home Game B,P,285,260,-25,52:21.2,7
5/25/2021,20PNR1VB,2021 NBA Playoffs - Round 1 - Home Game B,P,260,255,-5,52:27.3,8
5/25/2021,20PNR1VB,2021 NBA Playoffs - Round 1 - Home Game B,P,255,270,15,52:11.8,9
5/25/2021,20PNR1VB,2021 NBA Playoffs - Round 1 - Home Game B,P,270,290,20,52:05.0,10
5/25/2021,20PNR1VB,2021 NBA Playoffs - Round 1 - Home Game B,P,290,260,-30,52:05.4,11
5/25/2021,20PNR1VB,2021 NBA Playoffs - Round 1 - Home Game B,P,260,245,-15,52:12.9,12
5/25/2021,20PNR1VB,2021 NBA Playoffs - Round 1 - Home Game B,Q,0,315,315,12:53.0,1
5/25/2021,20PNR1VB,2021 NBA Playoffs - Round 1 - Home Game B,Q,315,1100,785,52:11.0,2
5/25/2021,20PNR1VB,2021 NBA Playoffs - Round 1 - Home Game B,Q,1100,465,-635,52:28.5,3
5/25/2021,20PNR1VB,2021 NBA Playoffs - Round 1 - Home Game B,Q,465,295,-170,52:11.2,4
5/25/2021,20PNR1VB,2021 NBA Playoffs - Round 1 - Home Game B,Q,295,345,50,52:31.6,5
5/25/2021,20PNR1VB,2021 NBA Playoffs - Round 1 - Home Game B,Q,345,230,-115,52:38.5,6
5/25/2021,20PNR1VB,2021 NBA Playoffs - Round 1 - Home Game B,Q,230,240,10,52:21.2,7
5/25/2021,20PNR1VB,2021 NBA Playoffs - Round 1 - Home Game B,Q,240,210,-30,52:27.3,8
5/25/2021,20PNR1VB,2021 NBA Playoffs - Round 1 - Home Game B,Q,210,220,10,52:11.8,9
5/25/2021,20PNR1VB,2021 NBA Playoffs - Round 1 - Home Game B,Q,220,240,20,52:05.0,10
5/25/2021,20PNR1VB,2021 NBA Playoffs - Round 1 - Home Game B,Q,240,215,-25,52:05.4,11
5/25/2021,20PNR1VB,2021 NBA Playoffs - Round 1 - Home Game B,Q,215,200,-15,52:12.9,12
5/25/2021,20PNR1VB,2021 NBA Playoffs - Round 1 - Home Game B,R,0,280,280,12:53.1,1
5/25/2021,20PNR1VB,2021 NBA Playoffs - Round 1 - Home Game B,R,280,1100,820,52:11.0,2
5/25/2021,20PNR1VB,2021 NBA Playoffs - Round 1 - Home Game B,R,1100,410,-690,52:28.5,3
5/25/2021,20PNR1VB,2021 NBA Playoffs - Round 1 - Home Game B,R,410,260,-150,52:11.2,4
5/25/2021,20PNR1VB,2021 NBA Playoffs - Round 1 - Home Game B,R,260,285,25,52:31.6,5
5/25/2021,20PNR1VB,2021 NBA Playoffs - Round 1 - Home Game B,R,285,205,-80,52:38.5,6
5/25/2021,20PNR1VB,2021 NBA Playoffs - Round 1 - Home Game B,R,205,200,-5,52:21.2,7
5/25/2021,20PNR1VB,2021 NBA Playoffs - Round 1 - Home Game B,R,200,185,-15,52:27.3,8
5/25/2021,20PNR1VB,2021 NBA Playoffs - Round 1 - Home Game B,R,185,195,10,52:11.8,9
5/25/2021,20PNR1VB,2021 NBA Playoffs - Round 1 - Home Game B,R,195,215,20,52:05.0,10
5/25/2021,20PNR1VB,2021 NBA Playoffs - Round 1 - Home Game B,R,215,200,-15,52:05.4,11
5/25/2021,20PNR1VB,2021 NBA Playoffs - Round 1 - Home Game B,R,200,175,-25,52:12.9,12
5/25/2021,20PNR1VB,2021 NBA Playoffs - Round 1 - Home Game B,R,175,190,15,52:12.6,13
5/25/2021,20PNR1VB,2021 NBA Playoffs - Round 1 - Home Game B,R,190,175,-15,52:06.7,14
5/25/2021,20PNR1VB,2021 NBA Playoffs - Round 1 - Home Game B,S,0,280,280,12:53.2,1
5/25/2021,20PNR1VB,2021 NBA Playoffs - Round 1 - Home Game B,S,280,1100,820,52:11.0,2
5/25/2021,20PNR1VB,2021 NBA Playoffs - Round 1 - Home Game B,S,1100,330,-770,52:28.5,3
5/25/2021,20PNR1VB,2021 NBA Playoffs - Round 1 - Home Game B,S,330,210,-120,52:11.2,4
5/25/2021,20PNR1VB,2021 NBA Playoffs - Round 1 - Home Game B,S,210,230,20,52:31.6,5
5/25/2021,20PNR1VB,2021 NBA Playoffs - Round 1 - Home Game B,S,230,205,-25,52:38.5,6
5/25/2021,20PNR1VB,2021 NBA Playoffs - Round 1 - Home Game B,S,205,190,-15,52:27.3,7
5/25/2021,20PNR1VB,2021 NBA Playoffs - Round 1 - Home Game B,S,190,200,10,52:11.8,8
5/25/2021,20PNR1VB,2021 NBA Playoffs - Round 1 - Home Game B,S,200,215,15,52:05.0,9
5/25/2021,20PNR1VB,2021 NBA Playoffs - Round 1 - Home Game B,S,215,200,-15,52:05.4,10
5/25/2021,20PNR1VB,2021 NBA Playoffs - Round 1 - Home Game B,S,200,175,-25,52:12.9,11
5/25/2021,20PNR1VB,2021 NBA Playoffs - Round 1 - Home Game B,S,175,190,15,52:12.6,12
5/25/2021,20PNR1VB,2021 NBA Playoffs - Round 1 - Home Game B,S,190,175,-15,52:06.7,13
5/25/2021,20PNR1VB,2021 NBA Playoffs - Round 1 - Home Game B,T,0,230,230,12:53.4,1
5/25/2021,20PNR1VB,2021 NBA Playoffs - Round 1 - Home Game B,T,230,1100,870,52:11.0,2
5/25/2021,20PNR1VB,2021 NBA Playoffs - Round 1 - Home Game B,T,1100,295,-805,52:28.5,3
5/25/2021,20PNR1VB,2021 NBA Playoffs - Round 1 - Home Game B,T,295,185,-110,52:11.2,4
5/25/2021,20PNR1VB,2021 NBA Playoffs - Round 1 - Home Game B,T,185,205,20,52:31.6,5
5/25/2021,20PNR1VB,2021 NBA Playoffs - Round 1 - Home Game B,T,205,180,-25,52:38.5,6
5/25/2021,20PNR1VB,2021 NBA Playoffs - Round 1 - Home Game B,T,180,160,-20,52:27.3,7
5/25/2021,20PNR1VB,2021 NBA Playoffs - Round 1 - Home Game B,T,160,170,10,52:11.8,8
5/25/2021,20PNR1VB,2021 NBA Playoffs - Round 1 - Home Game B,T,170,190,20,52:05.0,9
5/25/2021,20PNR1VB,2021 NBA Playoffs - Round 1 - Home Game B,T,190,170,-20,52:12.9,10
5/25/2021,20PNR1VB,2021 NBA Playoffs - Round 1 - Home Game B,T,170,175,5,52:05.7,11
5/25/2021,20PNR1VB,2021 NBA Playoffs - Round 1 - Home Game B,T,175,150,-25,52:06.7,12
5/25/2021,20PNR1VB,2021 NBA Playoffs - Round 1 - Home Game B,U,0,205,205,12:53.5,1
5/25/2021,20PNR1VB,2021 NBA Playoffs - Round 1 - Home Game B,U,205,1100,895,52:11.0,2
5/25/2021,20PNR1VB,2021 NBA Playoffs - Round 1 - Home Game B,U,1100,295,-805,52:28.5,3
5/25/2021,20PNR1VB,2021 NBA Playoffs - Round 1 - Home Game B,U,295,185,-110,52:11.2,4
5/25/2021,20PNR1VB,2021 NBA Playoffs - Round 1 - Home Game B,U,185,205,20,52:31.6,5
5/25/2021,20PNR1VB,2021 NBA Playoffs - Round 1 - Home Game B,U,205,155,-50,52:38.5,6
5/25/2021,20PNR1VB,2021 NBA Playoffs - Round 1 - Home Game B,U,155,145,-10,52:27.3,7
5/25/2021,20PNR1VB,2021 NBA Playoffs - Round 1 - Home Game B,U,145,150,5,52:11.8,8
5/25/2021,20PNR1VB,2021 NBA Playoffs - Round 1 - Home Game B,U,150,165,15,52:05.0,9
5/25/2021,20PNR1VB,2021 NBA Playoffs - Round 1 - Home Game B,U,165,155,-10,52:12.6,10
5/25/2021,20PNR1VB,2021 NBA Playoffs - Round 1 - Home Game B,U,155,160,5,52:05.7,11
5/25/2021,20PNR1VB,2021 NBA Playoffs - Round 1 - Home Game B,U,160,135,-25,52:06.7,12
5/25/2021,20PNR1VB,2021 NBA Playoffs - Round 1 - Home Game B,V,0,185,185,12:53.6,1
5/25/2021,20PNR1VB,2021 NBA Playoffs - Round 1 - Home Game B,V,185,1100,915,52:11.0,2
5/25/2021,20PNR1VB,2021 NBA Playoffs - Round 1 - Home Game B,V,1100,240,-860,52:28.5,3
5/25/2021,20PNR1VB,2021 NBA Playoffs - Round 1 - Home Game B,V,240,160,-80,52:11.2,4
5/25/2021,20PNR1VB,2021 NBA Playoffs - Round 1 - Home Game B,V,160,180,20,52:31.6,5
5/25/2021,20PNR1VB,2021 NBA Playoffs - Round 1 - Home Game B,V,180,139,-41,52:38.5,6
5/25/2021,20PNR1VB,2021 NBA Playoffs - Round 1 - Home Game B,V,139,130,-9,52:27.3,7
5/25/2021,20PNR1VB,2021 NBA Playoffs - Round 1 - Home Game B,V,130,135,5,52:11.8,8
5/25/2021,20PNR1VB,2021 NBA Playoffs - Round 1 - Home Game B,V,135,145,10,52:05.0,9
5/25/2021,20PNR1VB,2021 NBA Playoffs - Round 1 - Home Game B,V,145,140,-5,52:12.6,10
5/25/2021,20PNR1VB,2021 NBA Playoffs - Round 1 - Home Game B,V,140,145,5,52:05.7,11
5/25/2021,20PNR1VB,2021 NBA Playoffs - Round 1 - Home Game B,V,145,125,-20,52:06.7,12
5/25/2021,20PNR1VB,2021 NBA Playoffs - Round 1 - Home Game B,W,0,175,175,12:53.7,1
5/25/2021,20PNR1VB,2021 NBA Playoffs - Round 1 - Home Game B,W,175,1100,925,52:11.0,2
5/25/2021,20PNR1VB,2021 NBA Playoffs - Round 1 - Home Game B,W,1100,215,-885,52:28.5,3
5/25/2021,20PNR1VB,2021 NBA Playoffs - Round 1 - Home Game B,W,215,140,-75,52:11.2,4
5/25/2021,20PNR1VB,2021 NBA Playoffs - Round 1 - Home Game B,W,140,155,15,52:31.6,5
5/25/2021,20PNR1VB,2021 NBA Playoffs - Round 1 - Home Game B,W,155,125,-30,52:38.5,6
5/25/2021,20PNR1VB,2021 NBA Playoffs - Round 1 - Home Game B,W,125,120,-5,52:27.3,7
5/25/2021,20PNR1VB,2021 NBA Playoffs - Round 1 - Home Game B,W,120,125,5,52:11.8,8
5/25/2021,20PNR1VB,2021 NBA Playoffs - Round 1 - Home Game B,W,125,135,10,52:05.0,9
5/25/2021,20PNR1VB,2021 NBA Playoffs - Round 1 - Home Game B,W,135,130,-5,52:12.6,10
5/25/2021,20PNR1VB,2021 NBA Playoffs - Round 1 - Home Game B,W,130,135,5,52:05.7,11
5/25/2021,20PNR1VB,2021 NBA Playoffs - Round 1 - Home Game B,W,135,115,-20,52:06.7,12
5/25/2021,20PNR1VB,2021 NBA Playoffs - Round 1 - Home Game B,X,0,155,155,12:53.7,1
5/25/2021,20PNR1VB,2021 NBA Playoffs - Round 1 - Home Game B,X,155,1100,945,52:11.0,2
5/25/2021,20PNR1VB,2021 NBA Playoffs - Round 1 - Home Game B,X,1100,605,-495,52:28.5,3
5/25/2021,20PNR1VB,2021 NBA Playoffs - Round 1 - Home Game B,X,605,350,-255,52:11.2,4
5/25/2021,20PNR1VB,2021 NBA Playoffs - Round 1 - Home Game B,X,350,405,55,52:31.6,5
5/25/2021,20PNR1VB,2021 NBA Playoffs - Round 1 - Home Game B,X,405,395,-10,52:16.9,6
5/25/2021,20PNR1VB,2021 NBA Playoffs - Round 1 - Home Game B,X,395,119,-276,52:38.5,7
5/25/2021,20PNR1VB,2021 NBA Playoffs - Round 1 - Home Game B,X,119,110,-9,52:27.3,8
5/25/2021,20PNR1VB,2021 NBA Playoffs - Round 1 - Home Game B,X,110,115,5,52:11.8,9
5/25/2021,20PNR1VB,2021 NBA Playoffs - Round 1 - Home Game B,X,115,125,10,52:05.0,10
5/25/2021,20PNR1VB,2021 NBA Playoffs - Round 1 - Home Game B,X,125,120,-5,52:05.4,11
5/25/2021,20PNR1VB,2021 NBA Playoffs - Round 1 - Home Game B,X,120,125,5,52:12.9,12
5/25/2021,20PNR1VB,2021 NBA Playoffs - Round 1 - Home Game B,X,125,119,-6,52:05.8,13
5/25/2021,20PNR1VB,2021 NBA Playoffs - Round 1 - Home Game B,X,119,110,-9,52:12.6,14
5/25/2021,20PNR1VB,2021 NBA Playoffs - Round 1 - Home Game B,X,110,115,5,52:05.7,15
5/25/2021,20PNR1VB,2021 NBA Playoffs - Round 1 - Home Game B,X,115,110,-5,52:06.7,16
5/25/2021,20PNR1VB,2021 NBA Playoffs - Round 1 - Home Game B,Y,0,150,150,12:53.9,1
5/25/2021,20PNR1VB,2021 NBA Playoffs - Round 1 - Home Game B,Y,150,1100,950,52:11.0,2
5/25/2021,20PNR1VB,2021 NBA Playoffs - Round 1 - Home Game B,Y,1100,109,-991,52:38.5,3
5/25/2021,20PNR1VB,2021 NBA Playoffs - Round 1 - Home Game B,Y,109,99,-10,52:27.3,4
5/25/2021,20PNR1VB,2021 NBA Playoffs - Round 1 - Home Game B,Y,99,105,6,52:11.8,5
5/25/2021,20PNR1VB,2021 NBA Playoffs - Round 1 - Home Game B,Y,105,115,10,52:05.0,6
5/25/2021,20PNR1VB,2021 NBA Playoffs - Round 1 - Home Game B,Y,115,110,-5,52:05.4,7
5/25/2021,20PNR1VB,2021 NBA Playoffs - Round 1 - Home Game B,Y,110,115,5,52:12.9,8
5/25/2021,20PNR1VB,2021 NBA Playoffs - Round 1 - Home Game B,Y,115,109,-6,52:05.8,9
5/25/2021,20PNR1VB,2021 NBA Playoffs - Round 1 - Home Game B,Y,109,105,-4,52:12.6,10
5/25/2021,20PNR1VB,2021 NBA Playoffs - Round 1 - Home Game B,Y,105,109,4,52:05.7,11
5/25/2021,20PNR1VB,2021 NBA Playoffs - Round 1 - Home Game B,Y,109,105,-4,52:06.7,12
5/25/2021,20PNR1VB,2021 NBA Playoffs - Round 1 - Home Game B,Z,0,580,580,12:54.0,1
5/25/2021,20PNR1VB,2021 NBA Playoffs - Round 1 - Home Game B,Z,580,1100,520,52:11.0,2
5/25/2021,20PNR1VB,2021 NBA Playoffs - Round 1 - Home Game B,Z,1100,395,-705,52:38.5,3
5/25/2021,20PNR1VB,2021 NBA Playoffs - Round 1 - Home Game B,Z,395,340,-55,52:27.3,4
5/25/2021,20PNR1VB,2021 NBA Playoffs - Round 1 - Home Game B,Z,340,355,15,52:11.8,5
5/25/2021,20PNR1VB,2021 NBA Playoffs - Round 1 - Home Game B,Z,355,385,30,52:05.0,6
6/1/2021,20PNR1GC,2021 NBA Playoffs - Round 1 - Home Game C,1,0,236500,236500,32:46.0,1
6/1/2021,20PNR1GC,2021 NBA Playoffs - Round 1 - Home Game C,1,236500,157500,-79000,16:42.4,2
6/1/2021,20PNR1GC,2021 NBA Playoffs - Round 1 - Home Game C,1,157500,6685,-150815,34:56.5,3
6/1/2021,20PNR1GC,2021 NBA Playoffs - Round 1 - Home Game C,1,6685,1100,-5585,52:11.0,4
6/1/2021,20PNR1GC,2021 NBA Playoffs - Round 1 - Home Game C,1,1100,9000,7900,52:41.1,5
6/1/2021,20PNR1GC,2021 NBA Playoffs - Round 1 - Home Game C,1,9000,7000,-2000,52:05.2,6
6/1/2021,20PNR1GC,2021 NBA Playoffs - Round 1 - Home Game C,2,0,98900,98900,32:46.1,1
6/1/2021,20PNR1GC,2021 NBA Playoffs - Round 1 - Home Game C,2,98900,6685,-92215,34:56.5,2
6/1/2021,20PNR1GC,2021 NBA Playoffs - Round 1 - Home Game C,2,6685,1100,-5585,52:11.0,3
6/1/2021,20PNR1GC,2021 NBA Playoffs - Round 1 - Home Game C,2,1100,9000,7900,52:41.1,4
6/1/2021,20PNR1GC,2021 NBA Playoffs - Round 1 - Home Game C,2,9000,7000,-2000,52:05.2,5
6/1/2021,20PNR1GC,2021 NBA Playoffs - Round 1 - Home Game C,3,0,85979,85979,32:46.2,1
6/1/2021,20PNR1GC,2021 NBA Playoffs - Round 1 - Home Game C,3,85979,157500,71521,16:42.5,2
6/1/2021,20PNR1GC,2021 NBA Playoffs - Round 1 - Home Game C,3,157500,6685,-150815,34:56.5,3
6/1/2021,20PNR1GC,2021 NBA Playoffs - Round 1 - Home Game C,3,6685,1100,-5585,52:11.0,4
6/1/2021,20PNR1GC,2021 NBA Playoffs - Round 1 - Home Game C,3,1100,9000,7900,52:41.1,5
6/1/2021,20PNR1GC,2021 NBA Playoffs - Round 1 - Home Game C,3,9000,7000,-2000,52:05.2,6
6/1/2021,20PNR1GC,2021 NBA Playoffs - Round 1 - Home Game C,4,0,47300,47300,32:46.3,1
6/1/2021,20PNR1GC,2021 NBA Playoffs - Round 1 - Home Game C,4,47300,114540,67240,16:42.6,2
6/1/2021,20PNR1GC,2021 NBA Playoffs - Round 1 - Home Game C,4,114540,4860,-109680,34:56.5,3
6/1/2021,20PNR1GC,2021 NBA Playoffs - Round 1 - Home Game C,4,4860,1100,-3760,52:11.0,4
6/1/2021,20PNR1GC,2021 NBA Playoffs - Round 1 - Home Game C,4,1100,9000,7900,52:41.1,5
6/1/2021,20PNR1GC,2021 NBA Playoffs - Round 1 - Home Game C,4,9000,7000,-2000,52:05.2,6
6/1/2021,20PNR1GC,2021 NBA Playoffs - Round 1 - Home Game C,5,0,43000,43000,32:46.4,1
6/1/2021,20PNR1GC,2021 NBA Playoffs - Round 1 - Home Game C,5,43000,59120,16120,16:42.7,2
6/1/2021,20PNR1GC,2021 NBA Playoffs - Round 1 - Home Game C,5,59120,2440,-56680,34:56.5,3
6/1/2021,20PNR1GC,2021 NBA Playoffs - Round 1 - Home Game C,5,2440,2265,-175,54:56.8,4
6/1/2021,20PNR1GC,2021 NBA Playoffs - Round 1 - Home Game C,5,2440,2265,-175,54:56.8,5
6/1/2021,20PNR1GC,2021 NBA Playoffs - Round 1 - Home Game C,5,2265,1100,-1165,52:11.0,6
6/1/2021,20PNR1GC,2021 NBA Playoffs - Round 1 - Home Game C,5,1100,4000,2900,52:41.1,7
6/1/2021,20PNR1GC,2021 NBA Playoffs - Round 1 - Home Game C,5,4000,3100,-900,52:05.2,8
6/1/2021,20PNR1GC,2021 NBA Playoffs - Round 1 - Home Game C,5,3100,1400,-1700,52:05.2,9
6/1/2021,20PNR1GC,2021 NBA Playoffs - Round 1 - Home Game C,6,0,30100,30100,32:46.5,1
6/1/2021,20PNR1GC,2021 NBA Playoffs - Round 1 - Home Game C,6,30100,41100,11000,16:42.8,2
6/1/2021,20PNR1GC,2021 NBA Playoffs - Round 1 - Home Game C,6,41100,1695,-39405,34:56.5,3
6/1/2021,20PNR1GC,2021 NBA Playoffs - Round 1 - Home Game C,6,1695,1100,-595,52:11.0,4
6/1/2021,20PNR1GC,2021 NBA Playoffs - Round 1 - Home Game C,6,1100,1500,400,52:18.9,5
6/1/2021,20PNR1GC,2021 NBA Playoffs - Round 1 - Home Game C,6,1500,3000,1500,52:41.1,6
6/1/2021,20PNR1GC,2021 NBA Playoffs - Round 1 - Home Game C,6,3000,2340,-660,52:05.2,7
6/1/2021,20PNR1GC,2021 NBA Playoffs - Round 1 - Home Game C,6,2340,1200,-1140,52:05.2,8
6/1/2021,20PNR1GC,2021 NBA Playoffs - Round 1 - Home Game C,7,23650,38610,14960,16:42.9,1
6/1/2021,20PNR1GC,2021 NBA Playoffs - Round 1 - Home Game C,7,38610,1595,-37015,34:56.5,2
6/1/2021,20PNR1GC,2021 NBA Playoffs - Round 1 - Home Game C,7,1595,1650,55,54:56.8,3
6/1/2021,20PNR1GC,2021 NBA Playoffs - Round 1 - Home Game C,7,1595,1650,55,54:56.8,4
6/1/2021,20PNR1GC,2021 NBA Playoffs - Round 1 - Home Game C,7,1650,1100,-550,52:11.0,5
6/1/2021,20PNR1GC,2021 NBA Playoffs - Round 1 - Home Game C,7,1100,2600,1500,52:41.1,6
6/1/2021,20PNR1GC,2021 NBA Playoffs - Round 1 - Home Game C,7,2600,2030,-570,52:05.2,7
6/1/2021,20PNR1GC,2021 NBA Playoffs - Round 1 - Home Game C,7,2030,1100,-930,52:05.2,8
6/1/2021,20PNR1GC,2021 NBA Playoffs - Round 1 - Home Game C,8,18275,32420,14145,16:43.0,1
6/1/2021,20PNR1GC,2021 NBA Playoffs - Round 1 - Home Game C,8,32420,1155,-31265,34:56.5,2
6/1/2021,20PNR1GC,2021 NBA Playoffs - Round 1 - Home Game C,8,1155,1500,345,52:11.0,3
6/1/2021,20PNR1GC,2021 NBA Playoffs - Round 1 - Home Game C,8,1500,1490,-10,52:18.9,4
6/1/2021,20PNR1GC,2021 NBA Playoffs - Round 1 - Home Game C,8,1490,2240,750,52:19.3,5
6/1/2021,20PNR1GC,2021 NBA Playoffs - Round 1 - Home Game C,8,2240,1750,-490,52:05.2,6
6/1/2021,20PNR1GC,2021 NBA Playoffs - Round 1 - Home Game C,8,1750,805,-945,52:05.2,7
6/1/2021,20PNR1GC,2021 NBA Playoffs - Round 1 - Home Game C,9,17630,31260,13630,16:43.1,1
6/1/2021,20PNR1GC,2021 NBA Playoffs - Round 1 - Home Game C,9,31260,1115,-30145,34:56.5,2
6/1/2021,20PNR1GC,2021 NBA Playoffs - Round 1 - Home Game C,9,1115,1100,-15,52:11.0,3
6/1/2021,20PNR1GC,2021 NBA Playoffs - Round 1 - Home Game C,9,1100,1450,350,52:18.9,4
6/1/2021,20PNR1GC,2021 NBA Playoffs - Round 1 - Home Game C,9,1450,2180,730,52:19.3,5
6/1/2021,20PNR1GC,2021 NBA Playoffs - Round 1 - Home Game C,9,2180,1700,-480,52:05.2,6
6/1/2021,20PNR1GC,2021 NBA Playoffs - Round 1 - Home Game C,9,1700,775,-925,52:05.2,7
6/1/2021,20PNR1GC,2021 NBA Playoffs - Round 1 - Home Game C,A,0,16770,16770,32:46.6,1
6/1/2021,20PNR1GC,2021 NBA Playoffs - Round 1 - Home Game C,A,16770,29570,12800,16:43.2,2
6/1/2021,20PNR1GC,2021 NBA Playoffs - Round 1 - Home Game C,A,29570,1055,-28515,34:56.5,3
6/1/2021,20PNR1GC,2021 NBA Playoffs - Round 1 - Home Game C,A,1055,1100,45,52:11.0,4
6/1/2021,20PNR1GC,2021 NBA Playoffs - Round 1 - Home Game C,A,1100,1210,110,52:11.9,5
6/1/2021,20PNR1GC,2021 NBA Playoffs - Round 1 - Home Game C,A,1210,1490,280,52:18.5,6
6/1/2021,20PNR1GC,2021 NBA Playoffs - Round 1 - Home Game C,A,1490,1370,-120,52:18.9,7
6/1/2021,20PNR1GC,2021 NBA Playoffs - Round 1 - Home Game C,A,1370,2060,690,52:19.3,8
6/1/2021,20PNR1GC,2021 NBA Playoffs - Round 1 - Home Game C,A,2060,1610,-450,52:05.2,9
6/1/2021,20PNR1GC,2021 NBA Playoffs - Round 1 - Home Game C,A,1610,740,-870,52:05.2,10
6/1/2021,20PNR1GC,2021 NBA Playoffs - Round 1 - Home Game C,B,0,16125,16125,32:46.7,1
6/1/2021,20PNR1GC,2021 NBA Playoffs - Round 1 - Home Game C,B,16125,26880,10755,16:43.3,2
6/1/2021,20PNR1GC,2021 NBA Playoffs - Round 1 - Home Game C,B,26880,960,-25920,34:56.5,3
6/1/2021,20PNR1GC,2021 NBA Playoffs - Round 1 - Home Game C,B,960,1100,140,52:11.0,4
6/1/2021,20PNR1GC,2021 NBA Playoffs - Round 1 - Home Game C,B,1100,1170,70,52:11.9,5
6/1/2021,20PNR1GC,2021 NBA Playoffs - Round 1 - Home Game C,B,1170,1450,280,52:18.5,6
6/1/2021,20PNR1GC,2021 NBA Playoffs - Round 1 - Home Game C,B,1450,1250,-200,52:18.9,7
6/1/2021,20PNR1GC,2021 NBA Playoffs - Round 1 - Home Game C,B,1250,1880,630,52:19.3,8
6/1/2021,20PNR1GC,2021 NBA Playoffs - Round 1 - Home Game C,B,1880,1470,-410,52:05.2,9
6/1/2021,20PNR1GC,2021 NBA Playoffs - Round 1 - Home Game C,B,1470,750,-720,52:04.8,10
6/1/2021,20PNR1GC,2021 NBA Playoffs - Round 1 - Home Game C,B,750,675,-75,52:05.1,11
6/1/2021,20PNR1GC,2021 NBA Playoffs - Round 1 - Home Game C,C,0,15050,15050,32:46.8,1
6/1/2021,20PNR1GC,2021 NBA Playoffs - Round 1 - Home Game C,C,15050,24590,9540,16:43.4,2
6/1/2021,20PNR1GC,2021 NBA Playoffs - Round 1 - Home Game C,C,24590,875,-23715,34:56.5,3
6/1/2021,20PNR1GC,2021 NBA Playoffs - Round 1 - Home Game C,C,875,1100,225,52:11.0,4
6/1/2021,20PNR1GC,2021 NBA Playoffs - Round 1 - Home Game C,C,1100,1110,10,52:11.9,5
6/1/2021,20PNR1GC,2021 NBA Playoffs - Round 1 - Home Game C,C,1110,1370,260,52:18.5,6
6/1/2021,20PNR1GC,2021 NBA Playoffs - Round 1 - Home Game C,C,1370,1150,-220,52:18.9,7
6/1/2021,20PNR1GC,2021 NBA Playoffs - Round 1 - Home Game C,C,1150,1730,580,52:19.3,8
6/1/2021,20PNR1GC,2021 NBA Playoffs - Round 1 - Home Game C,C,1730,1350,-380,52:05.2,9
6/1/2021,20PNR1GC,2021 NBA Playoffs - Round 1 - Home Game C,C,1350,730,-620,52:04.8,10
6/1/2021,20PNR1GC,2021 NBA Playoffs - Round 1 - Home Game C,C,730,635,-95,52:05.1,11
6/1/2021,20PNR1GC,2021 NBA Playoffs - Round 1 - Home Game C,D,0,14190,14190,32:46.9,1
6/1/2021,20PNR1GC,2021 NBA Playoffs - Round 1 - Home Game C,D,14190,23530,9340,16:43.5,2
6/1/2021,20PNR1GC,2021 NBA Playoffs - Round 1 - Home Game C,D,23530,840,-22690,34:56.5,3
6/1/2021,20PNR1GC,2021 NBA Playoffs - Round 1 - Home Game C,D,840,1100,260,52:11.0,4
6/1/2021,20PNR1GC,2021 NBA Playoffs - Round 1 - Home Game C,D,1100,1010,-90,52:11.9,5
6/1/2021,20PNR1GC,2021 NBA Playoffs - Round 1 - Home Game C,D,1010,1250,240,52:18.5,6
6/1/2021,20PNR1GC,2021 NBA Playoffs - Round 1 - Home Game C,D,1250,1090,-160,52:18.9,7
6/1/2021,20PNR1GC,2021 NBA Playoffs - Round 1 - Home Game C,D,1090,1640,550,52:19.3,8
6/1/2021,20PNR1GC,2021 NBA Playoffs - Round 1 - Home Game C,D,1640,1280,-360,52:05.2,9
6/1/2021,20PNR1GC,2021 NBA Playoffs - Round 1 - Home Game C,D,1280,685,-595,52:04.8,10
6/1/2021,20PNR1GC,2021 NBA Playoffs - Round 1 - Home Game C,D,685,605,-80,52:05.1,11
6/1/2021,20PNR1GC,2021 NBA Playoffs - Round 1 - Home Game C,E,0,13330,13330,32:47.0,1
6/1/2021,20PNR1GC,2021 NBA Playoffs - Round 1 - Home Game C,E,13330,19750,6420,16:43.5,2
6/1/2021,20PNR1GC,2021 NBA Playoffs - Round 1 - Home Game C,E,19750,705,-19045,34:56.5,3
6/1/2021,20PNR1GC,2021 NBA Playoffs - Round 1 - Home Game C,E,705,1500,795,52:11.0,4
6/1/2021,20PNR1GC,2021 NBA Playoffs - Round 1 - Home Game C,E,1500,920,-580,52:11.9,5
6/1/2021,20PNR1GC,2021 NBA Playoffs - Round 1 - Home Game C,E,920,1150,230,52:18.5,6
6/1/2021,20PNR1GC,2021 NBA Playoffs - Round 1 - Home Game C,E,1150,915,-235,52:18.9,7
6/1/2021,20PNR1GC,2021 NBA Playoffs - Round 1 - Home Game C,E,915,1380,465,52:19.3,8
6/1/2021,20PNR1GC,2021 NBA Playoffs - Round 1 - Home Game C,E,1380,1080,-300,52:05.2,9
6/1/2021,20PNR1GC,2021 NBA Playoffs - Round 1 - Home Game C,E,1080,545,-535,52:04.8,10
6/1/2021,20PNR1GC,2021 NBA Playoffs - Round 1 - Home Game C,E,545,505,-40,52:05.1,11
6/1/2021,20PNR1GC,2021 NBA Playoffs - Round 1 - Home Game C,F,0,11395,11395,32:47.1,1
6/1/2021,20PNR1GC,2021 NBA Playoffs - Round 1 - Home Game C,F,11395,18710,7315,16:43.6,2
6/1/2021,20PNR1GC,2021 NBA Playoffs - Round 1 - Home Game C,F,18710,665,-18045,34:56.5,3
6/1/2021,20PNR1GC,2021 NBA Playoffs - Round 1 - Home Game C,F,665,1100,435,52:11.0,4
6/1/2021,20PNR1GC,2021 NBA Playoffs - Round 1 - Home Game C,F,1100,880,-220,52:11.9,5
6/1/2021,20PNR1GC,2021 NBA Playoffs - Round 1 - Home Game C,F,880,1090,210,52:18.5,6
6/1/2021,20PNR1GC,2021 NBA Playoffs - Round 1 - Home Game C,F,1090,870,-220,52:18.9,7
6/1/2021,20PNR1GC,2021 NBA Playoffs - Round 1 - Home Game C,F,870,1310,440,52:19.3,8
6/1/2021,20PNR1GC,2021 NBA Playoffs - Round 1 - Home Game C,F,1310,1020,-290,52:05.2,9
6/1/2021,20PNR1GC,2021 NBA Playoffs - Round 1 - Home Game C,F,1020,535,-485,52:04.8,10
6/1/2021,20PNR1GC,2021 NBA Playoffs - Round 1 - Home Game C,F,535,480,-55,52:05.1,11
6/1/2021,20PNR1GC,2021 NBA Playoffs - Round 1 - Home Game C,G,0,10965,10965,32:47.2,1
6/1/2021,20PNR1GC,2021 NBA Playoffs - Round 1 - Home Game C,G,10965,17090,6125,16:43.7,2
6/1/2021,20PNR1GC,2021 NBA Playoffs - Round 1 - Home Game C,G,17090,610,-16480,34:56.5,3
6/1/2021,20PNR1GC,2021 NBA Playoffs - Round 1 - Home Game C,G,610,1100,490,52:11.0,4
6/1/2021,20PNR1GC,2021 NBA Playoffs - Round 1 - Home Game C,G,1100,740,-360,52:11.9,5
6/1/2021,20PNR1GC,2021 NBA Playoffs - Round 1 - Home Game C,G,740,915,175,52:18.5,6
6/1/2021,20PNR1GC,2021 NBA Playoffs - Round 1 - Home Game C,G,915,795,-120,52:18.9,7
6/1/2021,20PNR1GC,2021 NBA Playoffs - Round 1 - Home Game C,G,795,1200,405,52:19.3,8
6/1/2021,20PNR1GC,2021 NBA Playoffs - Round 1 - Home Game C,G,1200,935,-265,52:05.2,9
6/1/2021,20PNR1GC,2021 NBA Playoffs - Round 1 - Home Game C,G,935,510,-425,52:04.8,10
6/1/2021,20PNR1GC,2021 NBA Playoffs - Round 1 - Home Game C,G,510,445,-65,52:05.1,11
6/1/2021,20PNR1GC,2021 NBA Playoffs - Round 1 - Home Game C,H,0,10535,10535,32:47.3,1
6/1/2021,20PNR1GC,2021 NBA Playoffs - Round 1 - Home Game C,H,10535,15770,5235,16:43.8,2
6/1/2021,20PNR1GC,2021 NBA Playoffs - Round 1 - Home Game C,H,15770,560,-15210,34:56.5,3
6/1/2021,20PNR1GC,2021 NBA Playoffs - Round 1 - Home Game C,H,560,1100,540,52:11.0,4
6/1/2021,20PNR1GC,2021 NBA Playoffs - Round 1 - Home Game C,H,1100,700,-400,52:11.9,5
6/1/2021,20PNR1GC,2021 NBA Playoffs - Round 1 - Home Game C,H,700,870,170,52:18.5,6
6/1/2021,20PNR1GC,2021 NBA Playoffs - Round 1 - Home Game C,H,870,730,-140,52:18.9,7
6/1/2021,20PNR1GC,2021 NBA Playoffs - Round 1 - Home Game C,H,730,1100,370,52:19.3,8
6/1/2021,20PNR1GC,2021 NBA Playoffs - Round 1 - Home Game C,H,1100,860,-240,52:05.2,9
6/1/2021,20PNR1GC,2021 NBA Playoffs - Round 1 - Home Game C,H,860,450,-410,52:04.8,10
6/1/2021,20PNR1GC,2021 NBA Playoffs - Round 1 - Home Game C,H,450,410,-40,52:05.1,11
6/1/2021,20PNR1GC,2021 NBA Playoffs - Round 1 - Home Game C,I,0,9030,9030,32:47.4,1
6/1/2021,20PNR1GC,2021 NBA Playoffs - Round 1 - Home Game C,I,9030,14180,5150,16:43.9,2
6/1/2021,20PNR1GC,2021 NBA Playoffs - Round 1 - Home Game C,I,14180,505,-13675,34:56.5,3
6/1/2021,20PNR1GC,2021 NBA Playoffs - Round 1 - Home Game C,I,505,1500,995,52:11.0,4
6/1/2021,20PNR1GC,2021 NBA Playoffs - Round 1 - Home Game C,I,1500,640,-860,52:11.9,5
6/1/2021,20PNR1GC,2021 NBA Playoffs - Round 1 - Home Game C,I,640,795,155,52:18.5,6
6/1/2021,20PNR1GC,2021 NBA Playoffs - Round 1 - Home Game C,I,795,660,-135,52:18.9,7
6/1/2021,20PNR1GC,2021 NBA Playoffs - Round 1 - Home Game C,I,660,990,330,52:19.3,8
6/1/2021,20PNR1GC,2021 NBA Playoffs - Round 1 - Home Game C,I,990,770,-220,52:05.2,9
6/1/2021,20PNR1GC,2021 NBA Playoffs - Round 1 - Home Game C,I,770,415,-355,52:04.8,10
6/1/2021,20PNR1GC,2021 NBA Playoffs - Round 1 - Home Game C,I,415,370,-45,52:05.1,11
6/1/2021,20PNR1GC,2021 NBA Playoffs - Round 1 - Home Game C,J,0,8385,8385,32:47.5,1
6/1/2021,20PNR1GC,2021 NBA Playoffs - Round 1 - Home Game C,J,8385,13080,4695,16:44.0,2
6/1/2021,20PNR1GC,2021 NBA Playoffs - Round 1 - Home Game C,J,13080,465,-12615,34:56.5,3
6/1/2021,20PNR1GC,2021 NBA Playoffs - Round 1 - Home Game C,J,465,1100,635,52:11.0,4
6/1/2021,20PNR1GC,2021 NBA Playoffs - Round 1 - Home Game C,J,1100,590,-510,52:11.9,5
6/1/2021,20PNR1GC,2021 NBA Playoffs - Round 1 - Home Game C,J,590,730,140,52:18.5,6
6/1/2021,20PNR1GC,2021 NBA Playoffs - Round 1 - Home Game C,J,730,605,-125,52:18.9,7
6/1/2021,20PNR1GC,2021 NBA Playoffs - Round 1 - Home Game C,J,605,910,305,52:19.3,8
6/1/2021,20PNR1GC,2021 NBA Playoffs - Round 1 - Home Game C,J,910,710,-200,52:05.2,9
6/1/2021,20PNR1GC,2021 NBA Playoffs - Round 1 - Home Game C,J,710,380,-330,52:04.8,10
6/1/2021,20PNR1GC,2021 NBA Playoffs - Round 1 - Home Game C,J,380,350,-30,52:05.1,11
6/1/2021,20PNR1GC,2021 NBA Playoffs - Round 1 - Home Game C,K,0,6880,6880,32:47.6,1
6/1/2021,20PNR1GC,2021 NBA Playoffs - Round 1 - Home Game C,K,6880,12160,5280,16:44.1,2
6/1/2021,20PNR1GC,2021 NBA Playoffs - Round 1 - Home Game C,K,12160,435,-11725,34:56.5,3
6/1/2021,20PNR1GC,2021 NBA Playoffs - Round 1 - Home Game C,K,435,1100,665,52:11.0,4
6/1/2021,20PNR1GC,2021 NBA Playoffs - Round 1 - Home Game C,K,1100,530,-570,52:11.9,5
6/1/2021,20PNR1GC,2021 NBA Playoffs - Round 1 - Home Game C,K,530,660,130,52:18.5,6
6/1/2021,20PNR1GC,2021 NBA Playoffs - Round 1 - Home Game C,K,660,565,-95,52:18.9,7
6/1/2021,20PNR1GC,2021 NBA Playoffs - Round 1 - Home Game C,K,565,850,285,52:19.3,8
6/1/2021,20PNR1GC,2021 NBA Playoffs - Round 1 - Home Game C,K,850,665,-185,52:05.2,9
6/1/2021,20PNR1GC,2021 NBA Playoffs - Round 1 - Home Game C,K,665,355,-310,52:04.8,10
6/1/2021,20PNR1GC,2021 NBA Playoffs - Round 1 - Home Game C,K,355,325,-30,52:05.1,11
6/1/2021,20PNR1GC,2021 NBA Playoffs - Round 1 - Home Game C,L,0,6450,6450,32:47.7,1
6/1/2021,20PNR1GC,2021 NBA Playoffs - Round 1 - Home Game C,L,6450,11930,5480,16:44.2,2
6/1/2021,20PNR1GC,2021 NBA Playoffs - Round 1 - Home Game C,L,11930,425,-11505,34:56.5,3
6/1/2021,20PNR1GC,2021 NBA Playoffs - Round 1 - Home Game C,L,425,1100,675,52:11.0,4
6/1/2021,20PNR1GC,2021 NBA Playoffs - Round 1 - Home Game C,L,1100,490,-610,52:11.9,5
6/1/2021,20PNR1GC,2021 NBA Playoffs - Round 1 - Home Game C,L,490,605,115,52:18.5,6
6/1/2021,20PNR1GC,2021 NBA Playoffs - Round 1 - Home Game C,L,605,550,-55,52:18.9,7
6/1/2021,20PNR1GC,2021 NBA Playoffs - Round 1 - Home Game C,L,550,825,275,52:19.3,8
6/1/2021,20PNR1GC,2021 NBA Playoffs - Round 1 - Home Game C,L,825,645,-180,52:05.2,9
6/1/2021,20PNR1GC,2021 NBA Playoffs - Round 1 - Home Game C,L,645,340,-305,52:04.8,10
6/1/2021,20PNR1GC,2021 NBA Playoffs - Round 1 - Home Game C,L,340,320,-20,52:05.1,11
6/1/2021,20PNR1GC,2021 NBA Playoffs - Round 1 - Home Game C,M,0,6020,6020,32:47.8,1
6/1/2021,20PNR1GC,2021 NBA Playoffs - Round 1 - Home Game C,M,6020,10470,4450,16:44.3,2
6/1/2021,20PNR1GC,2021 NBA Playoffs - Round 1 - Home Game C,M,10470,375,-10095,34:56.5,3
6/1/2021,20PNR1GC,2021 NBA Playoffs - Round 1 - Home Game C,M,375,1100,725,52:11.0,4
6/1/2021,20PNR1GC,2021 NBA Playoffs - Round 1 - Home Game C,M,1100,455,-645,52:11.9,5
6/1/2021,20PNR1GC,2021 NBA Playoffs - Round 1 - Home Game C,M,455,565,110,52:18.5,6
6/1/2021,20PNR1GC,2021 NBA Playoffs - Round 1 - Home Game C,M,565,485,-80,52:18.9,7
6/1/2021,20PNR1GC,2021 NBA Playoffs - Round 1 - Home Game C,M,485,730,245,52:19.3,8
6/1/2021,20PNR1GC,2021 NBA Playoffs - Round 1 - Home Game C,M,730,570,-160,52:05.2,9
6/1/2021,20PNR1GC,2021 NBA Playoffs - Round 1 - Home Game C,M,570,315,-255,52:04.8,10
6/1/2021,20PNR1GC,2021 NBA Playoffs - Round 1 - Home Game C,M,315,285,-30,52:05.1,11
6/1/2021,20PNR1GC,2021 NBA Playoffs - Round 1 - Home Game C,N,0,10105,10105,32:47.9,1
6/1/2021,20PNR1GC,2021 NBA Playoffs - Round 1 - Home Game C,N,10105,17290,7185,16:44.3,2
6/1/2021,20PNR1GC,2021 NBA Playoffs - Round 1 - Home Game C,N,17290,615,-16675,34:56.5,3
6/1/2021,20PNR1GC,2021 NBA Playoffs - Round 1 - Home Game C,N,615,1500,885,52:11.0,4
6/1/2021,20PNR1GC,2021 NBA Playoffs - Round 1 - Home Game C,N,1500,445,-1055,52:11.9,5
6/1/2021,20PNR1GC,2021 NBA Playoffs - Round 1 - Home Game C,N,445,550,105,52:18.5,6
6/1/2021,20PNR1GC,2021 NBA Playoffs - Round 1 - Home Game C,N,550,805,255,52:18.9,7
6/1/2021,20PNR1GC,2021 NBA Playoffs - Round 1 - Home Game C,N,805,1210,405,52:19.3,8
6/1/2021,20PNR1GC,2021 NBA Playoffs - Round 1 - Home Game C,N,1210,945,-265,52:05.2,9
6/1/2021,20PNR1GC,2021 NBA Playoffs - Round 1 - Home Game C,N,945,485,-460,52:04.8,10
6/1/2021,20PNR1GC,2021 NBA Playoffs - Round 1 - Home Game C,N,485,470,-15,52:05.1,11
6/1/2021,20PNR1GC,2021 NBA Playoffs - Round 1 - Home Game C,O,0,9460,9460,32:48.0,1
6/1/2021,20PNR1GC,2021 NBA Playoffs - Round 1 - Home Game C,O,9460,15550,6090,16:44.4,2
6/1/2021,20PNR1GC,2021 NBA Playoffs - Round 1 - Home Game C,O,15550,555,-14995,34:56.5,3
6/1/2021,20PNR1GC,2021 NBA Playoffs - Round 1 - Home Game C,O,555,1100,545,52:11.0,4
6/1/2021,20PNR1GC,2021 NBA Playoffs - Round 1 - Home Game C,O,1100,390,-710,52:11.9,5
6/1/2021,20PNR1GC,2021 NBA Playoffs - Round 1 - Home Game C,O,390,485,95,52:18.5,6
6/1/2021,20PNR1GC,2021 NBA Playoffs - Round 1 - Home Game C,O,485,720,235,52:18.9,7
6/1/2021,20PNR1GC,2021 NBA Playoffs - Round 1 - Home Game C,O,720,1080,360,52:19.3,8
6/1/2021,20PNR1GC,2021 NBA Playoffs - Round 1 - Home Game C,O,1080,840,-240,52:05.2,9
6/1/2021,20PNR1GC,2021 NBA Playoffs - Round 1 - Home Game C,O,840,435,-405,52:04.8,10
6/1/2021,20PNR1GC,2021 NBA Playoffs - Round 1 - Home Game C,O,435,415,-20,52:05.1,11
6/1/2021,20PNR1GC,2021 NBA Playoffs - Round 1 - Home Game C,P,0,7740,7740,32:48.1,1
6/1/2021,20PNR1GC,2021 NBA Playoffs - Round 1 - Home Game C,P,7740,13670,5930,16:44.5,2
6/1/2021,20PNR1GC,2021 NBA Playoffs - Round 1 - Home Game C,P,13670,485,-13185,34:56.5,3
6/1/2021,20PNR1GC,2021 NBA Playoffs - Round 1 - Home Game C,P,485,1100,615,52:11.0,4
6/1/2021,20PNR1GC,2021 NBA Playoffs - Round 1 - Home Game C,P,1100,645,-455,52:11.9,5
6/1/2021,20PNR1GC,2021 NBA Playoffs - Round 1 - Home Game C,P,645,805,160,52:18.5,6
6/1/2021,20PNR1GC,2021 NBA Playoffs - Round 1 - Home Game C,P,805,635,-170,52:18.9,7
6/1/2021,20PNR1GC,2021 NBA Playoffs - Round 1 - Home Game C,P,635,955,320,52:19.3,8
6/1/2021,20PNR1GC,2021 NBA Playoffs - Round 1 - Home Game C,P,955,745,-210,52:05.2,9
6/1/2021,20PNR1GC,2021 NBA Playoffs - Round 1 - Home Game C,P,745,400,-345,52:04.8,10
6/1/2021,20PNR1GC,2021 NBA Playoffs - Round 1 - Home Game C,P,400,360,-40,52:05.1,11
6/1/2021,20PNR1GC,2021 NBA Playoffs - Round 1 - Home Game C,Q,0,6880,6880,32:48.2,1
6/1/2021,20PNR1GC,2021 NBA Playoffs - Round 1 - Home Game C,Q,6880,10960,4080,16:44.6,2
6/1/2021,20PNR1GC,2021 NBA Playoffs - Round 1 - Home Game C,Q,10960,390,-10570,34:56.5,3
6/1/2021,20PNR1GC,2021 NBA Playoffs - Round 1 - Home Game C,Q,390,1100,710,52:11.0,4
6/1/2021,20PNR1GC,2021 NBA Playoffs - Round 1 - Home Game C,Q,1100,580,-520,52:11.9,5
6/1/2021,20PNR1GC,2021 NBA Playoffs - Round 1 - Home Game C,Q,580,720,140,52:18.5,6
6/1/2021,20PNR1GC,2021 NBA Playoffs - Round 1 - Home Game C,Q,720,510,-210,52:18.9,7
6/1/2021,20PNR1GC,2021 NBA Playoffs - Round 1 - Home Game C,Q,510,765,255,52:19.3,8
6/1/2021,20PNR1GC,2021 NBA Playoffs - Round 1 - Home Game C,Q,765,595,-170,52:05.2,9
6/1/2021,20PNR1GC,2021 NBA Playoffs - Round 1 - Home Game C,Q,595,320,-275,52:04.8,10
6/1/2021,20PNR1GC,2021 NBA Playoffs - Round 1 - Home Game C,Q,320,295,-25,52:05.1,11
6/1/2021,20PNR1GC,2021 NBA Playoffs - Round 1 - Home Game C,R,0,5590,5590,32:48.3,1
6/1/2021,20PNR1GC,2021 NBA Playoffs - Round 1 - Home Game C,R,5590,9740,4150,16:44.7,2
6/1/2021,20PNR1GC,2021 NBA Playoffs - Round 1 - Home Game C,R,9740,345,-9395,34:56.5,3
6/1/2021,20PNR1GC,2021 NBA Playoffs - Round 1 - Home Game C,R,345,1100,755,52:11.0,4
6/1/2021,20PNR1GC,2021 NBA Playoffs - Round 1 - Home Game C,R,1100,510,-590,52:11.9,5
6/1/2021,20PNR1GC,2021 NBA Playoffs - Round 1 - Home Game C,R,510,635,125,52:18.5,6
6/1/2021,20PNR1GC,2021 NBA Playoffs - Round 1 - Home Game C,R,635,455,-180,52:18.9,7
6/1/2021,20PNR1GC,2021 NBA Playoffs - Round 1 - Home Game C,R,455,685,230,52:19.3,8
6/1/2021,20PNR1GC,2021 NBA Playoffs - Round 1 - Home Game C,R,685,535,-150,52:05.2,9
6/1/2021,20PNR1GC,2021 NBA Playoffs - Round 1 - Home Game C,R,535,290,-245,52:04.8,10
6/1/2021,20PNR1GC,2021 NBA Playoffs - Round 1 - Home Game C,R,290,260,-30,52:05.1,11
6/1/2021,20PNR1GC,2021 NBA Playoffs - Round 1 - Home Game C,S,0,5590,5590,32:48.4,1
6/1/2021,20PNR1GC,2021 NBA Playoffs - Round 1 - Home Game C,S,5590,9740,4150,16:44.8,2
6/1/2021,20PNR1GC,2021 NBA Playoffs - Round 1 - Home Game C,S,9740,345,-9395,34:56.5,3
6/1/2021,20PNR1GC,2021 NBA Playoffs - Round 1 - Home Game C,S,345,1100,755,52:11.0,4
6/1/2021,20PNR1GC,2021 NBA Playoffs - Round 1 - Home Game C,S,1100,410,-690,52:11.9,5
6/1/2021,20PNR1GC,2021 NBA Playoffs - Round 1 - Home Game C,S,410,510,100,52:18.5,6
6/1/2021,20PNR1GC,2021 NBA Playoffs - Round 1 - Home Game C,S,510,455,-55,52:18.9,7
6/1/2021,20PNR1GC,2021 NBA Playoffs - Round 1 - Home Game C,S,455,685,230,52:19.3,8
6/1/2021,20PNR1GC,2021 NBA Playoffs - Round 1 - Home Game C,S,685,535,-150,52:05.2,9
6/1/2021,20PNR1GC,2021 NBA Playoffs - Round 1 - Home Game C,S,535,275,-260,52:04.8,10
6/1/2021,20PNR1GC,2021 NBA Playoffs - Round 1 - Home Game C,S,275,260,-15,52:05.1,11
6/1/2021,20PNR1GC,2021 NBA Playoffs - Round 1 - Home Game C,T,0,4730,4730,32:48.5,1
6/1/2021,20PNR1GC,2021 NBA Playoffs - Round 1 - Home Game C,T,4730,8030,3300,16:44.9,2
6/1/2021,20PNR1GC,2021 NBA Playoffs - Round 1 - Home Game C,T,8030,285,-7745,34:56.5,3
6/1/2021,20PNR1GC,2021 NBA Playoffs - Round 1 - Home Game C,T,285,1100,815,52:11.0,4
6/1/2021,20PNR1GC,2021 NBA Playoffs - Round 1 - Home Game C,T,1100,365,-735,52:11.9,5
6/1/2021,20PNR1GC,2021 NBA Playoffs - Round 1 - Home Game C,T,365,455,90,52:18.5,6
6/1/2021,20PNR1GC,2021 NBA Playoffs - Round 1 - Home Game C,T,455,370,-85,52:18.9,7
6/1/2021,20PNR1GC,2021 NBA Playoffs - Round 1 - Home Game C,T,370,555,185,52:19.3,8
6/1/2021,20PNR1GC,2021 NBA Playoffs - Round 1 - Home Game C,T,555,435,-120,52:05.2,9
6/1/2021,20PNR1GC,2021 NBA Playoffs - Round 1 - Home Game C,T,435,259,-176,52:04.8,10
6/1/2021,20PNR1GC,2021 NBA Playoffs - Round 1 - Home Game C,T,259,225,-34,52:05.1,11
6/1/2021,20PNR1GC,2021 NBA Playoffs - Round 1 - Home Game C,U,0,3870,3870,32:48.6,1
6/1/2021,20PNR1GC,2021 NBA Playoffs - Round 1 - Home Game C,U,3870,7130,3260,16:44.9,2
6/1/2021,20PNR1GC,2021 NBA Playoffs - Round 1 - Home Game C,U,7130,255,-6875,34:56.5,3
6/1/2021,20PNR1GC,2021 NBA Playoffs - Round 1 - Home Game C,U,255,1100,845,52:11.0,4
6/1/2021,20PNR1GC,2021 NBA Playoffs - Round 1 - Home Game C,U,1100,365,-735,52:11.9,5
6/1/2021,20PNR1GC,2021 NBA Playoffs - Round 1 - Home Game C,U,365,455,90,52:18.5,6
6/1/2021,20PNR1GC,2021 NBA Playoffs - Round 1 - Home Game C,U,455,335,-120,52:18.9,7
6/1/2021,20PNR1GC,2021 NBA Playoffs - Round 1 - Home Game C,U,335,505,170,52:19.3,8
6/1/2021,20PNR1GC,2021 NBA Playoffs - Round 1 - Home Game C,U,505,395,-110,52:05.2,9
6/1/2021,20PNR1GC,2021 NBA Playoffs - Round 1 - Home Game C,U,395,225,-170,52:04.8,10
6/1/2021,20PNR1GC,2021 NBA Playoffs - Round 1 - Home Game C,U,225,205,-20,52:05.1,11
6/1/2021,20PNR1GC,2021 NBA Playoffs - Round 1 - Home Game C,V,0,3440,3440,32:48.7,1
6/1/2021,20PNR1GC,2021 NBA Playoffs - Round 1 - Home Game C,V,3440,6430,2990,16:45.0,2
6/1/2021,20PNR1GC,2021 NBA Playoffs - Round 1 - Home Game C,V,6430,230,-6200,34:56.5,3
6/1/2021,20PNR1GC,2021 NBA Playoffs - Round 1 - Home Game C,V,230,1100,870,52:11.0,4
6/1/2021,20PNR1GC,2021 NBA Playoffs - Round 1 - Home Game C,V,1100,300,-800,52:11.9,5
6/1/2021,20PNR1GC,2021 NBA Playoffs - Round 1 - Home Game C,V,300,370,70,52:18.5,6
6/1/2021,20PNR1GC,2021 NBA Playoffs - Round 1 - Home Game C,V,370,295,-75,52:18.9,7
6/1/2021,20PNR1GC,2021 NBA Playoffs - Round 1 - Home Game C,V,295,445,150,52:19.3,8
6/1/2021,20PNR1GC,2021 NBA Playoffs - Round 1 - Home Game C,V,445,345,-100,52:05.2,9
6/1/2021,20PNR1GC,2021 NBA Playoffs - Round 1 - Home Game C,V,345,205,-140,52:04.8,10
6/1/2021,20PNR1GC,2021 NBA Playoffs - Round 1 - Home Game C,V,205,180,-25,52:05.1,11
6/1/2021,20PNR1GC,2021 NBA Playoffs - Round 1 - Home Game C,W,0,3010,3010,32:48.8,1
6/1/2021,20PNR1GC,2021 NBA Playoffs - Round 1 - Home Game C,W,3010,6030,3020,16:45.1,2
6/1/2021,20PNR1GC,2021 NBA Playoffs - Round 1 - Home Game C,W,6030,215,-5815,34:56.5,3
6/1/2021,20PNR1GC,2021 NBA Playoffs - Round 1 - Home Game C,W,215,1100,885,52:11.0,4
6/1/2021,20PNR1GC,2021 NBA Playoffs - Round 1 - Home Game C,W,1100,265,-835,52:11.9,5
6/1/2021,20PNR1GC,2021 NBA Playoffs - Round 1 - Home Game C,W,265,335,70,52:18.5,6
6/1/2021,20PNR1GC,2021 NBA Playoffs - Round 1 - Home Game C,W,335,280,-55,52:18.9,7
6/1/2021,20PNR1GC,2021 NBA Playoffs - Round 1 - Home Game C,W,280,420,140,52:19.3,8
6/1/2021,20PNR1GC,2021 NBA Playoffs - Round 1 - Home Game C,W,420,330,-90,52:05.2,9
6/1/2021,20PNR1GC,2021 NBA Playoffs - Round 1 - Home Game C,W,330,180,-150,52:04.8,10
6/1/2021,20PNR1GC,2021 NBA Playoffs - Round 1 - Home Game C,W,180,160,-20,52:05.1,11
6/1/2021,20PNR1GC,2021 NBA Playoffs - Round 1 - Home Game C,X,0,2795,2795,32:48.9,1
6/1/2021,20PNR1GC,2021 NBA Playoffs - Round 1 - Home Game C,X,2795,5370,2575,16:45.2,2
6/1/2021,20PNR1GC,2021 NBA Playoffs - Round 1 - Home Game C,X,5370,190,-5180,34:56.5,3
6/1/2021,20PNR1GC,2021 NBA Playoffs - Round 1 - Home Game C,X,190,1100,910,52:11.0,4
6/1/2021,20PNR1GC,2021 NBA Playoffs - Round 1 - Home Game C,X,1100,755,-345,52:11.9,5
6/1/2021,20PNR1GC,2021 NBA Playoffs - Round 1 - Home Game C,X,755,940,185,52:18.5,6
6/1/2021,20PNR1GC,2021 NBA Playoffs - Round 1 - Home Game C,X,940,250,-690,52:18.9,7
6/1/2021,20PNR1GC,2021 NBA Playoffs - Round 1 - Home Game C,X,250,375,125,52:19.3,8
6/1/2021,20PNR1GC,2021 NBA Playoffs - Round 1 - Home Game C,X,375,295,-80,52:05.2,9
6/1/2021,20PNR1GC,2021 NBA Playoffs - Round 1 - Home Game C,X,295,170,-125,52:04.8,10
6/1/2021,20PNR1GC,2021 NBA Playoffs - Round 1 - Home Game C,X,170,150,-20,52:05.1,11
6/1/2021,20PNR1GC,2021 NBA Playoffs - Round 1 - Home Game C,Y,0,2795,2795,32:49.0,1
6/1/2021,20PNR1GC,2021 NBA Playoffs - Round 1 - Home Game C,Y,2795,5220,2425,16:45.3,2
6/1/2021,20PNR1GC,2021 NBA Playoffs - Round 1 - Home Game C,Y,5220,185,-5035,34:56.5,3
6/1/2021,20PNR1GC,2021 NBA Playoffs - Round 1 - Home Game C,Y,185,1100,915,52:11.0,4
6/1/2021,20PNR1GC,2021 NBA Playoffs - Round 1 - Home Game C,Y,1100,240,-860,52:18.9,5
6/1/2021,20PNR1GC,2021 NBA Playoffs - Round 1 - Home Game C,Y,240,360,120,52:19.3,6
6/1/2021,20PNR1GC,2021 NBA Playoffs - Round 1 - Home Game C,Y,360,280,-80,52:05.2,7
6/1/2021,20PNR1GC,2021 NBA Playoffs - Round 1 - Home Game C,Y,280,155,-125,52:04.8,8
6/1/2021,20PNR1GC,2021 NBA Playoffs - Round 1 - Home Game C,Y,155,135,-20,52:05.1,9
6/1/2021,20PNR1GC,2021 NBA Playoffs - Round 1 - Home Game C,Z,0,999999,999999,32:49.1,1
6/1/2021,20PNR1GC,2021 NBA Playoffs - Round 1 - Home Game C,Z,999999,20190,-979809,16:45.4,2
6/1/2021,20PNR1GC,2021 NBA Playoffs - Round 1 - Home Game C,Z,20190,720,-19470,34:56.5,3
6/1/2021,20PNR1GC,2021 NBA Playoffs - Round 1 - Home Game C,Z,720,1100,380,52:11.0,4
6/1/2021,20PNR1GC,2021 NBA Playoffs - Round 1 - Home Game C,Z,1100,940,-160,52:18.9,5
6/1/2021,20PNR1GC,2021 NBA Playoffs - Round 1 - Home Game C,Z,940,1410,470,52:19.3,6
6/1/2021,20PNR1GC,2021 NBA Playoffs - Round 1 - Home Game C,Z,1410,1100,-310,52:05.2,7
6/1/2021,20PNR1VC,2021 NBA Playoffs - Round 1 - Home Game C,1,0,6685,6685,20:54.8,1
6/1/2021,20PNR1VC,2021 NBA Playoffs - Round 1 - Home Game C,1,6685,1100,-5585,52:16.2,2
6/1/2021,20PNR1VC,2021 NBA Playoffs - Round 1 - Home Game C,1,1100,7000,5900,53:07.7,3
6/1/2021,20PNR1VC,2021 NBA Playoffs - Round 1 - Home Game C,1,7000,5000,-2000,52:05.0,4
6/1/2021,20PNR1VC,2021 NBA Playoffs - Round 1 - Home Game C,2,0,6685,6685,20:55.0,1
6/1/2021,20PNR1VC,2021 NBA Playoffs - Round 1 - Home Game C,2,6685,1100,-5585,52:16.2,2
6/1/2021,20PNR1VC,2021 NBA Playoffs - Round 1 - Home Game C,2,1100,7000,5900,53:07.7,3
6/1/2021,20PNR1VC,2021 NBA Playoffs - Round 1 - Home Game C,2,7000,5000,-2000,52:05.0,4
6/1/2021,20PNR1VC,2021 NBA Playoffs - Round 1 - Home Game C,3,0,6685,6685,20:55.1,1
6/1/2021,20PNR1VC,2021 NBA Playoffs - Round 1 - Home Game C,3,6685,1100,-5585,52:16.2,2
6/1/2021,20PNR1VC,2021 NBA Playoffs - Round 1 - Home Game C,3,1100,7000,5900,53:07.7,3
6/1/2021,20PNR1VC,2021 NBA Playoffs - Round 1 - Home Game C,3,7000,5000,-2000,52:05.0,4
6/1/2021,20PNR1VC,2021 NBA Playoffs - Round 1 - Home Game C,4,0,4860,4860,20:55.2,1
6/1/2021,20PNR1VC,2021 NBA Playoffs - Round 1 - Home Game C,4,4860,1100,-3760,52:16.2,2
6/1/2021,20PNR1VC,2021 NBA Playoffs - Round 1 - Home Game C,4,1100,7000,5900,53:07.7,3
6/1/2021,20PNR1VC,2021 NBA Playoffs - Round 1 - Home Game C,4,7000,5000,-2000,52:05.0,4
6/1/2021,20PNR1VC,2021 NBA Playoffs - Round 1 - Home Game C,5,0,2265,2265,20:55.4,1
6/1/2021,20PNR1VC,2021 NBA Playoffs - Round 1 - Home Game C,5,2265,1100,-1165,52:16.2,2
6/1/2021,20PNR1VC,2021 NBA Playoffs - Round 1 - Home Game C,5,1100,1400,300,53:07.7,3
6/1/2021,20PNR1VC,2021 NBA Playoffs - Round 1 - Home Game C,5,1400,775,-625,52:05.0,4
6/1/2021,20PNR1VC,2021 NBA Playoffs - Round 1 - Home Game C,6,0,1695,1695,20:55.5,1
6/1/2021,20PNR1VC,2021 NBA Playoffs - Round 1 - Home Game C,6,1695,1100,-595,52:16.2,2
6/1/2021,20PNR1VC,2021 NBA Playoffs - Round 1 - Home Game C,6,1100,1500,400,52:44.2,3
6/1/2021,20PNR1VC,2021 NBA Playoffs - Round 1 - Home Game C,6,1500,1200,-300,53:07.7,4
6/1/2021,20PNR1VC,2021 NBA Playoffs - Round 1 - Home Game C,6,1200,750,-450,52:05.0,5
6/1/2021,20PNR1VC,2021 NBA Playoffs - Round 1 - Home Game C,7,1650,1100,-550,52:16.2,1
6/1/2021,20PNR1VC,2021 NBA Playoffs - Round 1 - Home Game C,7,1100,725,-375,52:05.0,2
6/1/2021,20PNR1VC,2021 NBA Playoffs - Round 1 - Home Game C,8,1155,1500,345,52:16.2,1
6/1/2021,20PNR1VC,2021 NBA Playoffs - Round 1 - Home Game C,8,1500,800,-700,52:44.2,2
6/1/2021,20PNR1VC,2021 NBA Playoffs - Round 1 - Home Game C,8,800,990,190,52:05.1,3
6/1/2021,20PNR1VC,2021 NBA Playoffs - Round 1 - Home Game C,8,990,685,-305,52:05.0,4
6/1/2021,20PNR1VC,2021 NBA Playoffs - Round 1 - Home Game C,8,685,680,-5,52:05.0,5
6/1/2021,20PNR1VC,2021 NBA Playoffs - Round 1 - Home Game C,8,680,655,-25,52:05.2,6
6/1/2021,20PNR1VC,2021 NBA Playoffs - Round 1 - Home Game C,9,1115,1100,-15,52:16.2,1
6/1/2021,20PNR1VC,2021 NBA Playoffs - Round 1 - Home Game C,9,1100,765,-335,52:44.2,2
6/1/2021,20PNR1VC,2021 NBA Playoffs - Round 1 - Home Game C,9,765,785,20,52:05.1,3
6/1/2021,20PNR1VC,2021 NBA Playoffs - Round 1 - Home Game C,9,785,660,-125,52:05.0,4
6/1/2021,20PNR1VC,2021 NBA Playoffs - Round 1 - Home Game C,9,660,655,-5,52:05.0,5
6/1/2021,20PNR1VC,2021 NBA Playoffs - Round 1 - Home Game C,9,655,630,-25,52:05.2,6
6/1/2021,20PNR1VC,2021 NBA Playoffs - Round 1 - Home Game C,A,0,1055,1055,20:55.7,1
6/1/2021,20PNR1VC,2021 NBA Playoffs - Round 1 - Home Game C,A,1055,1100,45,52:16.2,2
6/1/2021,20PNR1VC,2021 NBA Playoffs - Round 1 - Home Game C,A,1100,1210,110,52:34.1,3
6/1/2021,20PNR1VC,2021 NBA Playoffs - Round 1 - Home Game C,A,1210,765,-445,52:05.1,4
6/1/2021,20PNR1VC,2021 NBA Playoffs - Round 1 - Home Game C,A,765,800,35,52:05.3,5
6/1/2021,20PNR1VC,2021 NBA Playoffs - Round 1 - Home Game C,A,800,725,-75,52:44.2,6
6/1/2021,20PNR1VC,2021 NBA Playoffs - Round 1 - Home Game C,A,725,645,-80,52:05.1,7
6/1/2021,20PNR1VC,2021 NBA Playoffs - Round 1 - Home Game C,A,645,630,-15,52:05.0,8
6/1/2021,20PNR1VC,2021 NBA Playoffs - Round 1 - Home Game C,A,630,625,-5,52:05.0,9
6/1/2021,20PNR1VC,2021 NBA Playoffs - Round 1 - Home Game C,A,625,600,-25,52:05.2,10
6/1/2021,20PNR1VC,2021 NBA Playoffs - Round 1 - Home Game C,B,0,960,960,20:55.8,1
6/1/2021,20PNR1VC,2021 NBA Playoffs - Round 1 - Home Game C,B,960,1500,540,52:16.2,2
6/1/2021,20PNR1VC,2021 NBA Playoffs - Round 1 - Home Game C,B,1500,1170,-330,52:34.1,3
6/1/2021,20PNR1VC,2021 NBA Playoffs - Round 1 - Home Game C,B,1170,735,-435,52:05.1,4
6/1/2021,20PNR1VC,2021 NBA Playoffs - Round 1 - Home Game C,B,735,765,30,52:05.3,5
6/1/2021,20PNR1VC,2021 NBA Playoffs - Round 1 - Home Game C,B,765,665,-100,52:44.2,6
6/1/2021,20PNR1VC,2021 NBA Playoffs - Round 1 - Home Game C,B,665,630,-35,52:05.1,7
6/1/2021,20PNR1VC,2021 NBA Playoffs - Round 1 - Home Game C,B,630,565,-65,52:05.0,8
6/1/2021,20PNR1VC,2021 NBA Playoffs - Round 1 - Home Game C,B,565,560,-5,52:05.0,9
6/1/2021,20PNR1VC,2021 NBA Playoffs - Round 1 - Home Game C,B,560,535,-25,52:05.2,10
6/1/2021,20PNR1VC,2021 NBA Playoffs - Round 1 - Home Game C,C,0,875,875,20:56.0,1
6/1/2021,20PNR1VC,2021 NBA Playoffs - Round 1 - Home Game C,C,875,1100,225,52:16.2,2
6/1/2021,20PNR1VC,2021 NBA Playoffs - Round 1 - Home Game C,C,1100,1110,10,52:34.1,3
6/1/2021,20PNR1VC,2021 NBA Playoffs - Round 1 - Home Game C,C,1110,695,-415,52:05.1,4
6/1/2021,20PNR1VC,2021 NBA Playoffs - Round 1 - Home Game C,C,695,725,30,52:05.3,5
6/1/2021,20PNR1VC,2021 NBA Playoffs - Round 1 - Home Game C,C,725,625,-100,52:44.2,6
6/1/2021,20PNR1VC,2021 NBA Playoffs - Round 1 - Home Game C,C,625,615,-10,52:05.1,7
6/1/2021,20PNR1VC,2021 NBA Playoffs - Round 1 - Home Game C,C,615,530,-85,52:05.0,8
6/1/2021,20PNR1VC,2021 NBA Playoffs - Round 1 - Home Game C,C,530,525,-5,52:05.0,9
6/1/2021,20PNR1VC,2021 NBA Playoffs - Round 1 - Home Game C,C,525,500,-25,52:05.2,10
6/1/2021,20PNR1VC,2021 NBA Playoffs - Round 1 - Home Game C,D,0,840,840,20:56.1,1
6/1/2021,20PNR1VC,2021 NBA Playoffs - Round 1 - Home Game C,D,840,1100,260,52:16.2,2
6/1/2021,20PNR1VC,2021 NBA Playoffs - Round 1 - Home Game C,D,1100,1010,-90,52:34.1,3
6/1/2021,20PNR1VC,2021 NBA Playoffs - Round 1 - Home Game C,D,1010,630,-380,52:05.1,4
6/1/2021,20PNR1VC,2021 NBA Playoffs - Round 1 - Home Game C,D,630,665,35,52:05.3,5
6/1/2021,20PNR1VC,2021 NBA Playoffs - Round 1 - Home Game C,D,665,605,-60,52:44.2,6
6/1/2021,20PNR1VC,2021 NBA Playoffs - Round 1 - Home Game C,D,605,580,-25,52:05.1,7
6/1/2021,20PNR1VC,2021 NBA Playoffs - Round 1 - Home Game C,D,580,505,-75,52:05.0,8
6/1/2021,20PNR1VC,2021 NBA Playoffs - Round 1 - Home Game C,D,505,500,-5,52:05.0,9
6/1/2021,20PNR1VC,2021 NBA Playoffs - Round 1 - Home Game C,D,500,485,-15,52:05.2,10
6/1/2021,20PNR1VC,2021 NBA Playoffs - Round 1 - Home Game C,E,0,705,705,20:56.2,1
6/1/2021,20PNR1VC,2021 NBA Playoffs - Round 1 - Home Game C,E,705,1100,395,52:16.2,2
6/1/2021,20PNR1VC,2021 NBA Playoffs - Round 1 - Home Game C,E,1100,920,-180,52:34.1,3
6/1/2021,20PNR1VC,2021 NBA Playoffs - Round 1 - Home Game C,E,920,585,-335,52:05.1,4
6/1/2021,20PNR1VC,2021 NBA Playoffs - Round 1 - Home Game C,E,585,625,40,52:05.3,5
6/1/2021,20PNR1VC,2021 NBA Playoffs - Round 1 - Home Game C,E,625,520,-105,52:44.2,6
6/1/2021,20PNR1VC,2021 NBA Playoffs - Round 1 - Home Game C,E,520,460,-60,52:05.1,7
6/1/2021,20PNR1VC,2021 NBA Playoffs - Round 1 - Home Game C,E,460,425,-35,52:05.0,8
6/1/2021,20PNR1VC,2021 NBA Playoffs - Round 1 - Home Game C,E,425,420,-5,52:05.0,9
6/1/2021,20PNR1VC,2021 NBA Playoffs - Round 1 - Home Game C,E,420,405,-15,52:05.2,10
6/1/2021,20PNR1VC,2021 NBA Playoffs - Round 1 - Home Game C,F,0,665,665,20:56.4,1
6/1/2021,20PNR1VC,2021 NBA Playoffs - Round 1 - Home Game C,F,665,1100,435,52:16.2,2
6/1/2021,20PNR1VC,2021 NBA Playoffs - Round 1 - Home Game C,F,1100,880,-220,52:34.1,3
6/1/2021,20PNR1VC,2021 NBA Playoffs - Round 1 - Home Game C,F,880,560,-320,52:05.1,4
6/1/2021,20PNR1VC,2021 NBA Playoffs - Round 1 - Home Game C,F,560,605,45,52:05.3,5
6/1/2021,20PNR1VC,2021 NBA Playoffs - Round 1 - Home Game C,F,605,490,-115,52:44.2,6
6/1/2021,20PNR1VC,2021 NBA Playoffs - Round 1 - Home Game C,F,490,450,-40,52:05.1,7
6/1/2021,20PNR1VC,2021 NBA Playoffs - Round 1 - Home Game C,F,450,405,-45,52:05.0,8
6/1/2021,20PNR1VC,2021 NBA Playoffs - Round 1 - Home Game C,F,405,400,-5,52:05.0,9
6/1/2021,20PNR1VC,2021 NBA Playoffs - Round 1 - Home Game C,F,400,385,-15,52:05.2,10
6/1/2021,20PNR1VC,2021 NBA Playoffs - Round 1 - Home Game C,G,0,610,610,20:56.5,1
6/1/2021,20PNR1VC,2021 NBA Playoffs - Round 1 - Home Game C,G,610,1500,890,52:16.2,2
6/1/2021,20PNR1VC,2021 NBA Playoffs - Round 1 - Home Game C,G,1500,740,-760,52:34.1,3
6/1/2021,20PNR1VC,2021 NBA Playoffs - Round 1 - Home Game C,G,740,475,-265,52:05.1,4
6/1/2021,20PNR1VC,2021 NBA Playoffs - Round 1 - Home Game C,G,475,520,45,52:05.3,5
6/1/2021,20PNR1VC,2021 NBA Playoffs - Round 1 - Home Game C,G,520,460,-60,52:44.2,6
6/1/2021,20PNR1VC,2021 NBA Playoffs - Round 1 - Home Game C,G,460,430,-30,52:05.1,7
6/1/2021,20PNR1VC,2021 NBA Playoffs - Round 1 - Home Game C,G,430,375,-55,52:05.0,8
6/1/2021,20PNR1VC,2021 NBA Playoffs - Round 1 - Home Game C,G,375,370,-5,52:05.0,9
6/1/2021,20PNR1VC,2021 NBA Playoffs - Round 1 - Home Game C,G,370,355,-15,52:05.2,10
6/1/2021,20PNR1VC,2021 NBA Playoffs - Round 1 - Home Game C,H,0,560,560,20:56.6,1
6/1/2021,20PNR1VC,2021 NBA Playoffs - Round 1 - Home Game C,H,560,1100,540,52:16.2,2
6/1/2021,20PNR1VC,2021 NBA Playoffs - Round 1 - Home Game C,H,1100,700,-400,52:34.1,3
6/1/2021,20PNR1VC,2021 NBA Playoffs - Round 1 - Home Game C,H,700,445,-255,52:05.1,4
6/1/2021,20PNR1VC,2021 NBA Playoffs - Round 1 - Home Game C,H,445,490,45,52:05.3,5
6/1/2021,20PNR1VC,2021 NBA Playoffs - Round 1 - Home Game C,H,490,425,-65,52:44.2,6
6/1/2021,20PNR1VC,2021 NBA Playoffs - Round 1 - Home Game C,H,425,380,-45,52:05.1,7
6/1/2021,20PNR1VC,2021 NBA Playoffs - Round 1 - Home Game C,H,380,345,-35,52:05.0,8
6/1/2021,20PNR1VC,2021 NBA Playoffs - Round 1 - Home Game C,H,345,340,-5,52:05.0,9
6/1/2021,20PNR1VC,2021 NBA Playoffs - Round 1 - Home Game C,H,340,325,-15,52:05.2,10
6/1/2021,20PNR1VC,2021 NBA Playoffs - Round 1 - Home Game C,I,0,505,505,20:56.8,1
6/1/2021,20PNR1VC,2021 NBA Playoffs - Round 1 - Home Game C,I,505,1100,595,52:16.2,2
6/1/2021,20PNR1VC,2021 NBA Playoffs - Round 1 - Home Game C,I,1100,640,-460,52:34.1,3
6/1/2021,20PNR1VC,2021 NBA Playoffs - Round 1 - Home Game C,I,640,415,-225,52:05.1,4
6/1/2021,20PNR1VC,2021 NBA Playoffs - Round 1 - Home Game C,I,415,460,45,52:05.3,5
6/1/2021,20PNR1VC,2021 NBA Playoffs - Round 1 - Home Game C,I,460,395,-65,52:44.2,6
6/1/2021,20PNR1VC,2021 NBA Playoffs - Round 1 - Home Game C,I,395,350,-45,52:05.1,7
6/1/2021,20PNR1VC,2021 NBA Playoffs - Round 1 - Home Game C,I,350,315,-35,52:05.0,8
6/1/2021,20PNR1VC,2021 NBA Playoffs - Round 1 - Home Game C,I,315,310,-5,52:05.0,9
6/1/2021,20PNR1VC,2021 NBA Playoffs - Round 1 - Home Game C,I,310,291,-19,52:05.2,10
6/1/2021,20PNR1VC,2021 NBA Playoffs - Round 1 - Home Game C,J,0,465,465,20:56.9,1
6/1/2021,20PNR1VC,2021 NBA Playoffs - Round 1 - Home Game C,J,465,1100,635,52:16.2,2
6/1/2021,20PNR1VC,2021 NBA Playoffs - Round 1 - Home Game C,J,1100,590,-510,52:34.1,3
6/1/2021,20PNR1VC,2021 NBA Playoffs - Round 1 - Home Game C,J,590,380,-210,52:05.1,4
6/1/2021,20PNR1VC,2021 NBA Playoffs - Round 1 - Home Game C,J,380,425,45,52:05.3,5
6/1/2021,20PNR1VC,2021 NBA Playoffs - Round 1 - Home Game C,J,425,370,-55,52:44.2,6
6/1/2021,20PNR1VC,2021 NBA Playoffs - Round 1 - Home Game C,J,370,325,-45,52:05.1,7
6/1/2021,20PNR1VC,2021 NBA Playoffs - Round 1 - Home Game C,J,325,295,-30,52:05.0,8
6/1/2021,20PNR1VC,2021 NBA Playoffs - Round 1 - Home Game C,J,295,290,-5,52:05.0,9
6/1/2021,20PNR1VC,2021 NBA Playoffs - Round 1 - Home Game C,J,290,271,-19,52:05.2,10
6/1/2021,20PNR1VC,2021 NBA Playoffs - Round 1 - Home Game C,K,0,435,435,20:57.0,1
6/1/2021,20PNR1VC,2021 NBA Playoffs - Round 1 - Home Game C,K,435,1100,665,52:16.2,2
6/1/2021,20PNR1VC,2021 NBA Playoffs - Round 1 - Home Game C,K,1100,530,-570,52:34.1,3
6/1/2021,20PNR1VC,2021 NBA Playoffs - Round 1 - Home Game C,K,530,350,-180,52:05.1,4
6/1/2021,20PNR1VC,2021 NBA Playoffs - Round 1 - Home Game C,K,350,395,45,52:05.3,5
6/1/2021,20PNR1VC,2021 NBA Playoffs - Round 1 - Home Game C,K,395,350,-45,52:44.2,6
6/1/2021,20PNR1VC,2021 NBA Playoffs - Round 1 - Home Game C,K,350,299,-51,52:05.1,7
6/1/2021,20PNR1VC,2021 NBA Playoffs - Round 1 - Home Game C,K,299,275,-24,52:05.0,8
6/1/2021,20PNR1VC,2021 NBA Playoffs - Round 1 - Home Game C,K,275,270,-5,52:05.0,9
6/1/2021,20PNR1VC,2021 NBA Playoffs - Round 1 - Home Game C,K,270,251,-19,52:05.2,10
6/1/2021,20PNR1VC,2021 NBA Playoffs - Round 1 - Home Game C,L,0,425,425,20:57.1,1
6/1/2021,20PNR1VC,2021 NBA Playoffs - Round 1 - Home Game C,L,425,1100,675,52:16.2,2
6/1/2021,20PNR1VC,2021 NBA Playoffs - Round 1 - Home Game C,L,1100,490,-610,52:34.1,3
6/1/2021,20PNR1VC,2021 NBA Playoffs - Round 1 - Home Game C,L,490,325,-165,52:05.1,4
6/1/2021,20PNR1VC,2021 NBA Playoffs - Round 1 - Home Game C,L,325,370,45,52:05.3,5
6/1/2021,20PNR1VC,2021 NBA Playoffs - Round 1 - Home Game C,L,370,340,-30,52:44.2,6
6/1/2021,20PNR1VC,2021 NBA Playoffs - Round 1 - Home Game C,L,340,290,-50,52:05.1,7
6/1/2021,20PNR1VC,2021 NBA Playoffs - Round 1 - Home Game C,L,290,270,-20,52:05.0,8
6/1/2021,20PNR1VC,2021 NBA Playoffs - Round 1 - Home Game C,L,270,265,-5,52:05.0,9
6/1/2021,20PNR1VC,2021 NBA Playoffs - Round 1 - Home Game C,L,265,246,-19,52:05.2,10
6/1/2021,20PNR1VC,2021 NBA Playoffs - Round 1 - Home Game C,M,0,375,375,20:57.3,1
6/1/2021,20PNR1VC,2021 NBA Playoffs - Round 1 - Home Game C,M,375,1100,725,52:16.2,2
6/1/2021,20PNR1VC,2021 NBA Playoffs - Round 1 - Home Game C,M,1100,455,-645,52:34.1,3
6/1/2021,20PNR1VC,2021 NBA Playoffs - Round 1 - Home Game C,M,455,305,-150,52:05.1,4
6/1/2021,20PNR1VC,2021 NBA Playoffs - Round 1 - Home Game C,M,305,350,45,52:05.3,5
6/1/2021,20PNR1VC,2021 NBA Playoffs - Round 1 - Home Game C,M,350,315,-35,52:44.2,6
6/1/2021,20PNR1VC,2021 NBA Playoffs - Round 1 - Home Game C,M,315,270,-45,52:05.1,7
6/1/2021,20PNR1VC,2021 NBA Playoffs - Round 1 - Home Game C,M,270,240,-30,52:05.0,8
6/1/2021,20PNR1VC,2021 NBA Playoffs - Round 1 - Home Game C,M,240,235,-5,52:05.0,9
6/1/2021,20PNR1VC,2021 NBA Playoffs - Round 1 - Home Game C,M,235,221,-14,52:05.2,10
6/1/2021,20PNR1VC,2021 NBA Playoffs - Round 1 - Home Game C,N,0,615,615,20:57.4,1
6/1/2021,20PNR1VC,2021 NBA Playoffs - Round 1 - Home Game C,N,615,1100,485,52:16.2,2
6/1/2021,20PNR1VC,2021 NBA Playoffs - Round 1 - Home Game C,N,1100,445,-655,52:34.1,3
6/1/2021,20PNR1VC,2021 NBA Playoffs - Round 1 - Home Game C,N,445,295,-150,52:05.1,4
6/1/2021,20PNR1VC,2021 NBA Playoffs - Round 1 - Home Game C,N,295,340,45,52:05.3,5
6/1/2021,20PNR1VC,2021 NBA Playoffs - Round 1 - Home Game C,N,340,475,135,52:44.2,6
6/1/2021,20PNR1VC,2021 NBA Playoffs - Round 1 - Home Game C,N,475,410,-65,52:05.1,7
6/1/2021,20PNR1VC,2021 NBA Playoffs - Round 1 - Home Game C,N,410,395,-15,52:05.0,8
6/1/2021,20PNR1VC,2021 NBA Playoffs - Round 1 - Home Game C,N,395,390,-5,52:05.0,9
6/1/2021,20PNR1VC,2021 NBA Playoffs - Round 1 - Home Game C,N,390,380,-10,52:05.2,10
6/1/2021,20PNR1VC,2021 NBA Playoffs - Round 1 - Home Game C,O,0,555,555,20:57.5,1
6/1/2021,20PNR1VC,2021 NBA Playoffs - Round 1 - Home Game C,O,555,1100,545,52:16.2,2
6/1/2021,20PNR1VC,2021 NBA Playoffs - Round 1 - Home Game C,O,1100,390,-710,52:34.1,3
6/1/2021,20PNR1VC,2021 NBA Playoffs - Round 1 - Home Game C,O,390,265,-125,52:05.1,4
6/1/2021,20PNR1VC,2021 NBA Playoffs - Round 1 - Home Game C,O,265,315,50,52:05.3,5
6/1/2021,20PNR1VC,2021 NBA Playoffs - Round 1 - Home Game C,O,315,430,115,52:44.2,6
6/1/2021,20PNR1VC,2021 NBA Playoffs - Round 1 - Home Game C,O,430,370,-60,52:05.1,7
6/1/2021,20PNR1VC,2021 NBA Playoffs - Round 1 - Home Game C,O,370,350,-20,52:05.0,8
6/1/2021,20PNR1VC,2021 NBA Playoffs - Round 1 - Home Game C,O,350,345,-5,52:05.0,9
6/1/2021,20PNR1VC,2021 NBA Playoffs - Round 1 - Home Game C,O,345,335,-10,52:05.2,10
6/1/2021,20PNR1VC,2021 NBA Playoffs - Round 1 - Home Game C,P,0,485,485,20:57.6,1
6/1/2021,20PNR1VC,2021 NBA Playoffs - Round 1 - Home Game C,P,485,1100,615,52:16.2,2
6/1/2021,20PNR1VC,2021 NBA Playoffs - Round 1 - Home Game C,P,1100,645,-455,52:34.1,3
6/1/2021,20PNR1VC,2021 NBA Playoffs - Round 1 - Home Game C,P,645,435,-210,52:05.1,4
6/1/2021,20PNR1VC,2021 NBA Playoffs - Round 1 - Home Game C,P,435,475,40,52:05.3,5
6/1/2021,20PNR1VC,2021 NBA Playoffs - Round 1 - Home Game C,P,475,385,-90,52:44.2,6
6/1/2021,20PNR1VC,2021 NBA Playoffs - Round 1 - Home Game C,P,385,330,-55,52:05.1,7
6/1/2021,20PNR1VC,2021 NBA Playoffs - Round 1 - Home Game C,P,330,305,-25,52:05.0,8
6/1/2021,20PNR1VC,2021 NBA Playoffs - Round 1 - Home Game C,P,305,300,-5,52:05.0,9
6/1/2021,20PNR1VC,2021 NBA Playoffs - Round 1 - Home Game C,P,300,286,-14,52:05.2,10
6/1/2021,20PNR1VC,2021 NBA Playoffs - Round 1 - Home Game C,Q,0,390,390,20:57.7,1
6/1/2021,20PNR1VC,2021 NBA Playoffs - Round 1 - Home Game C,Q,390,1100,710,52:16.2,2
6/1/2021,20PNR1VC,2021 NBA Playoffs - Round 1 - Home Game C,Q,1100,580,-520,52:34.1,3
6/1/2021,20PNR1VC,2021 NBA Playoffs - Round 1 - Home Game C,Q,580,390,-190,52:05.1,4
6/1/2021,20PNR1VC,2021 NBA Playoffs - Round 1 - Home Game C,Q,390,430,40,52:05.3,5
6/1/2021,20PNR1VC,2021 NBA Playoffs - Round 1 - Home Game C,Q,430,310,-120,52:44.2,6
6/1/2021,20PNR1VC,2021 NBA Playoffs - Round 1 - Home Game C,Q,310,270,-40,52:05.1,7
6/1/2021,20PNR1VC,2021 NBA Playoffs - Round 1 - Home Game C,Q,270,250,-20,52:05.0,8
6/1/2021,20PNR1VC,2021 NBA Playoffs - Round 1 - Home Game C,Q,250,245,-5,52:05.0,9
6/1/2021,20PNR1VC,2021 NBA Playoffs - Round 1 - Home Game C,Q,245,231,-14,52:05.2,10
6/1/2021,20PNR1VC,2021 NBA Playoffs - Round 1 - Home Game C,R,0,345,345,20:57.8,1
6/1/2021,20PNR1VC,2021 NBA Playoffs - Round 1 - Home Game C,R,345,1100,755,52:16.2,2
6/1/2021,20PNR1VC,2021 NBA Playoffs - Round 1 - Home Game C,R,1100,510,-590,52:34.1,3
6/1/2021,20PNR1VC,2021 NBA Playoffs - Round 1 - Home Game C,R,510,340,-170,52:05.1,4
6/1/2021,20PNR1VC,2021 NBA Playoffs - Round 1 - Home Game C,R,340,385,45,52:05.3,5
6/1/2021,20PNR1VC,2021 NBA Playoffs - Round 1 - Home Game C,R,385,280,-105,52:44.2,6
6/1/2021,20PNR1VC,2021 NBA Playoffs - Round 1 - Home Game C,R,280,245,-35,52:05.1,7
6/1/2021,20PNR1VC,2021 NBA Playoffs - Round 1 - Home Game C,R,245,220,-25,52:05.0,8
6/1/2021,20PNR1VC,2021 NBA Playoffs - Round 1 - Home Game C,R,220,215,-5,52:05.0,9
6/1/2021,20PNR1VC,2021 NBA Playoffs - Round 1 - Home Game C,R,215,201,-14,52:05.2,10
6/1/2021,20PNR1VC,2021 NBA Playoffs - Round 1 - Home Game C,S,0,345,345,20:57.9,1
6/1/2021,20PNR1VC,2021 NBA Playoffs - Round 1 - Home Game C,S,345,1100,755,52:16.2,2
6/1/2021,20PNR1VC,2021 NBA Playoffs - Round 1 - Home Game C,S,1100,410,-690,52:34.1,3
6/1/2021,20PNR1VC,2021 NBA Playoffs - Round 1 - Home Game C,S,410,275,-135,52:05.1,4
6/1/2021,20PNR1VC,2021 NBA Playoffs - Round 1 - Home Game C,S,275,310,35,52:05.3,5
6/1/2021,20PNR1VC,2021 NBA Playoffs - Round 1 - Home Game C,S,310,280,-30,52:44.2,6
6/1/2021,20PNR1VC,2021 NBA Playoffs - Round 1 - Home Game C,S,280,235,-45,52:05.1,7
6/1/2021,20PNR1VC,2021 NBA Playoffs - Round 1 - Home Game C,S,235,220,-15,52:05.0,8
6/1/2021,20PNR1VC,2021 NBA Playoffs - Round 1 - Home Game C,S,220,215,-5,52:05.0,9
6/1/2021,20PNR1VC,2021 NBA Playoffs - Round 1 - Home Game C,S,215,201,-14,52:05.2,10
6/1/2021,20PNR1VC,2021 NBA Playoffs - Round 1 - Home Game C,T,0,285,285,20:58.0,1
6/1/2021,20PNR1VC,2021 NBA Playoffs - Round 1 - Home Game C,T,285,1100,815,52:16.2,2
6/1/2021,20PNR1VC,2021 NBA Playoffs - Round 1 - Home Game C,T,1100,365,-735,52:34.1,3
6/1/2021,20PNR1VC,2021 NBA Playoffs - Round 1 - Home Game C,T,365,245,-120,52:05.1,4
6/1/2021,20PNR1VC,2021 NBA Playoffs - Round 1 - Home Game C,T,245,280,35,52:05.3,5
6/1/2021,20PNR1VC,2021 NBA Playoffs - Round 1 - Home Game C,T,280,255,-25,52:44.2,6
6/1/2021,20PNR1VC,2021 NBA Playoffs - Round 1 - Home Game C,T,255,220,-35,52:05.1,7
6/1/2021,20PNR1VC,2021 NBA Playoffs - Round 1 - Home Game C,T,220,190,-30,52:05.0,8
6/1/2021,20PNR1VC,2021 NBA Playoffs - Round 1 - Home Game C,T,190,185,-5,52:05.0,9
6/1/2021,20PNR1VC,2021 NBA Playoffs - Round 1 - Home Game C,T,185,171,-14,52:05.2,10
6/1/2021,20PNR1VC,2021 NBA Playoffs - Round 1 - Home Game C,U,0,255,255,20:58.1,1
6/1/2021,20PNR1VC,2021 NBA Playoffs - Round 1 - Home Game C,U,255,1100,845,52:16.2,2
6/1/2021,20PNR1VC,2021 NBA Playoffs - Round 1 - Home Game C,U,1100,365,-735,52:34.1,3
6/1/2021,20PNR1VC,2021 NBA Playoffs - Round 1 - Home Game C,U,365,245,-120,52:05.1,4
6/1/2021,20PNR1VC,2021 NBA Playoffs - Round 1 - Home Game C,U,245,280,35,52:05.3,5
6/1/2021,20PNR1VC,2021 NBA Playoffs - Round 1 - Home Game C,U,280,220,-60,52:44.2,6
6/1/2021,20PNR1VC,2021 NBA Playoffs - Round 1 - Home Game C,U,220,185,-35,52:05.1,7
6/1/2021,20PNR1VC,2021 NBA Playoffs - Round 1 - Home Game C,U,185,170,-15,52:05.0,8
6/1/2021,20PNR1VC,2021 NBA Playoffs - Round 1 - Home Game C,U,170,165,-5,52:05.0,9
6/1/2021,20PNR1VC,2021 NBA Playoffs - Round 1 - Home Game C,U,165,151,-14,52:05.2,10
6/1/2021,20PNR1VC,2021 NBA Playoffs - Round 1 - Home Game C,V,0,230,230,20:58.2,1
6/1/2021,20PNR1VC,2021 NBA Playoffs - Round 1 - Home Game C,V,230,1100,870,52:16.2,2
6/1/2021,20PNR1VC,2021 NBA Playoffs - Round 1 - Home Game C,V,1100,300,-800,52:34.1,3
6/1/2021,20PNR1VC,2021 NBA Playoffs - Round 1 - Home Game C,V,300,210,-90,52:05.1,4
6/1/2021,20PNR1VC,2021 NBA Playoffs - Round 1 - Home Game C,V,210,255,45,52:05.3,5
6/1/2021,20PNR1VC,2021 NBA Playoffs - Round 1 - Home Game C,V,255,200,-55,52:44.2,6
6/1/2021,20PNR1VC,2021 NBA Playoffs - Round 1 - Home Game C,V,200,170,-30,52:05.1,7
6/1/2021,20PNR1VC,2021 NBA Playoffs - Round 1 - Home Game C,V,170,155,-15,52:05.0,8
6/1/2021,20PNR1VC,2021 NBA Playoffs - Round 1 - Home Game C,V,155,150,-5,52:05.0,9
6/1/2021,20PNR1VC,2021 NBA Playoffs - Round 1 - Home Game C,V,150,136,-14,52:05.2,10
6/1/2021,20PNR1VC,2021 NBA Playoffs - Round 1 - Home Game C,W,0,215,215,20:58.4,1
6/1/2021,20PNR1VC,2021 NBA Playoffs - Round 1 - Home Game C,W,215,1100,885,52:16.2,2
6/1/2021,20PNR1VC,2021 NBA Playoffs - Round 1 - Home Game C,W,1100,265,-835,52:34.1,3
6/1/2021,20PNR1VC,2021 NBA Playoffs - Round 1 - Home Game C,W,265,185,-80,52:05.1,4
6/1/2021,20PNR1VC,2021 NBA Playoffs - Round 1 - Home Game C,W,185,220,35,52:05.3,5
6/1/2021,20PNR1VC,2021 NBA Playoffs - Round 1 - Home Game C,W,220,185,-35,52:44.2,6
6/1/2021,20PNR1VC,2021 NBA Playoffs - Round 1 - Home Game C,W,185,155,-30,52:05.1,7
6/1/2021,20PNR1VC,2021 NBA Playoffs - Round 1 - Home Game C,W,155,140,-15,52:05.0,8
6/1/2021,20PNR1VC,2021 NBA Playoffs - Round 1 - Home Game C,W,140,135,-5,52:05.0,9
6/1/2021,20PNR1VC,2021 NBA Playoffs - Round 1 - Home Game C,W,135,121,-14,52:05.2,10
6/1/2021,20PNR1VC,2021 NBA Playoffs - Round 1 - Home Game C,X,0,190,190,20:58.5,1
6/1/2021,20PNR1VC,2021 NBA Playoffs - Round 1 - Home Game C,X,190,1100,910,52:16.2,2
6/1/2021,20PNR1VC,2021 NBA Playoffs - Round 1 - Home Game C,X,1100,755,-345,52:34.1,3
6/1/2021,20PNR1VC,2021 NBA Playoffs - Round 1 - Home Game C,X,755,460,-295,52:05.1,4
6/1/2021,20PNR1VC,2021 NBA Playoffs - Round 1 - Home Game C,X,460,500,40,52:05.3,5
6/1/2021,20PNR1VC,2021 NBA Playoffs - Round 1 - Home Game C,X,500,170,-330,52:44.2,6
6/1/2021,20PNR1VC,2021 NBA Playoffs - Round 1 - Home Game C,X,170,145,-25,52:05.1,7
6/1/2021,20PNR1VC,2021 NBA Playoffs - Round 1 - Home Game C,X,145,130,-15,52:05.0,8
6/1/2021,20PNR1VC,2021 NBA Playoffs - Round 1 - Home Game C,X,130,125,-5,52:05.0,9
6/1/2021,20PNR1VC,2021 NBA Playoffs - Round 1 - Home Game C,X,125,111,-14,52:05.2,10
6/1/2021,20PNR1VC,2021 NBA Playoffs - Round 1 - Home Game C,Y,0,185,185,20:58.6,1
6/1/2021,20PNR1VC,2021 NBA Playoffs - Round 1 - Home Game C,Y,185,1100,915,52:16.2,2
6/1/2021,20PNR1VC,2021 NBA Playoffs - Round 1 - Home Game C,Y,1100,155,-945,52:44.2,3
6/1/2021,20PNR1VC,2021 NBA Playoffs - Round 1 - Home Game C,Y,155,130,-25,52:05.1,4
6/1/2021,20PNR1VC,2021 NBA Playoffs - Round 1 - Home Game C,Y,130,120,-10,52:05.0,5
6/1/2021,20PNR1VC,2021 NBA Playoffs - Round 1 - Home Game C,Y,120,115,-5,52:05.0,6
6/1/2021,20PNR1VC,2021 NBA Playoffs - Round 1 - Home Game C,Y,115,101,-14,52:05.2,7
6/1/2021,20PNR1VC,2021 NBA Playoffs - Round 1 - Home Game C,Z,0,720,720,20:58.7,1
6/1/2021,20PNR1VC,2021 NBA Playoffs - Round 1 - Home Game C,Z,720,1100,380,52:16.2,2
6/1/2021,20PNR1VC,2021 NBA Playoffs - Round 1 - Home Game C,Z,1100,500,-600,52:44.2,3
6/1/2021,20PNR1VC,2021 NBA Playoffs - Round 1 - Home Game C,Z,500,495,-5,52:05.0,4
6/1/2021,20PNR1VC,2021 NBA Playoffs - Round 1 - Home Game C,Z,495,480,-15,52:05.2,5
6/5/2021,20PNR1GD,2021 NBA Playoffs - Round 1 - Home Game D,1,0,236500,236500,32:49.1,1
6/5/2021,20PNR1GD,2021 NBA Playoffs - Round 1 - Home Game D,1,236500,157500,-79000,16:45.5,2
6/5/2021,20PNR1GD,2021 NBA Playoffs - Round 1 - Home Game D,1,157500,6685,-150815,34:56.5,3
6/5/2021,20PNR1GD,2021 NBA Playoffs - Round 1 - Home Game D,1,6685,1100,-5585,52:16.4,4
6/5/2021,20PNR1GD,2021 NBA Playoffs - Round 1 - Home Game D,1,1100,9000,7900,52:46.8,5
6/5/2021,20PNR1GD,2021 NBA Playoffs - Round 1 - Home Game D,1,9000,7000,-2000,52:11.0,6
6/5/2021,20PNR1GD,2021 NBA Playoffs - Round 1 - Home Game D,2,0,98900,98900,32:49.2,1
6/5/2021,20PNR1GD,2021 NBA Playoffs - Round 1 - Home Game D,2,98900,6685,-92215,34:56.5,2
6/5/2021,20PNR1GD,2021 NBA Playoffs - Round 1 - Home Game D,2,6685,1100,-5585,52:16.4,3
6/5/2021,20PNR1GD,2021 NBA Playoffs - Round 1 - Home Game D,2,1100,9000,7900,52:46.8,4
6/5/2021,20PNR1GD,2021 NBA Playoffs - Round 1 - Home Game D,2,9000,7000,-2000,52:11.0,5
6/5/2021,20PNR1GD,2021 NBA Playoffs - Round 1 - Home Game D,3,0,85979,85979,32:49.3,1
6/5/2021,20PNR1GD,2021 NBA Playoffs - Round 1 - Home Game D,3,85979,157500,71521,16:45.6,2
6/5/2021,20PNR1GD,2021 NBA Playoffs - Round 1 - Home Game D,3,157500,6685,-150815,34:56.5,3
6/5/2021,20PNR1GD,2021 NBA Playoffs - Round 1 - Home Game D,3,6685,1100,-5585,52:16.4,4
6/5/2021,20PNR1GD,2021 NBA Playoffs - Round 1 - Home Game D,3,1100,9000,7900,52:46.8,5
6/5/2021,20PNR1GD,2021 NBA Playoffs - Round 1 - Home Game D,3,9000,7000,-2000,52:11.0,6
6/5/2021,20PNR1GD,2021 NBA Playoffs - Round 1 - Home Game D,4,0,47300,47300,32:49.4,1
6/5/2021,20PNR1GD,2021 NBA Playoffs - Round 1 - Home Game D,4,47300,114540,67240,16:45.7,2
6/5/2021,20PNR1GD,2021 NBA Playoffs - Round 1 - Home Game D,4,114540,4860,-109680,34:56.5,3
6/5/2021,20PNR1GD,2021 NBA Playoffs - Round 1 - Home Game D,4,4860,1100,-3760,52:16.4,4
6/5/2021,20PNR1GD,2021 NBA Playoffs - Round 1 - Home Game D,4,1100,9000,7900,52:46.8,5
6/5/2021,20PNR1GD,2021 NBA Playoffs - Round 1 - Home Game D,4,9000,7000,-2000,52:11.0,6
6/5/2021,20PNR1GD,2021 NBA Playoffs - Round 1 - Home Game D,5,0,43000,43000,32:49.6,1
6/5/2021,20PNR1GD,2021 NBA Playoffs - Round 1 - Home Game D,5,43000,59120,16120,16:45.8,2
6/5/2021,20PNR1GD,2021 NBA Playoffs - Round 1 - Home Game D,5,59120,2440,-56680,34:56.5,3
6/5/2021,20PNR1GD,2021 NBA Playoffs - Round 1 - Home Game D,5,2440,2265,-175,54:56.8,4
6/5/2021,20PNR1GD,2021 NBA Playoffs - Round 1 - Home Game D,5,2440,2265,-175,54:56.8,5
6/5/2021,20PNR1GD,2021 NBA Playoffs - Round 1 - Home Game D,5,2265,1100,-1165,52:16.4,6
6/5/2021,20PNR1GD,2021 NBA Playoffs - Round 1 - Home Game D,5,1100,4000,2900,52:46.8,7
6/5/2021,20PNR1GD,2021 NBA Playoffs - Round 1 - Home Game D,5,4000,3100,-900,52:11.0,8
6/5/2021,20PNR1GD,2021 NBA Playoffs - Round 1 - Home Game D,6,0,30100,30100,32:49.6,1
6/5/2021,20PNR1GD,2021 NBA Playoffs - Round 1 - Home Game D,6,30100,41100,11000,16:45.9,2
6/5/2021,20PNR1GD,2021 NBA Playoffs - Round 1 - Home Game D,6,41100,1695,-39405,34:56.5,3
6/5/2021,20PNR1GD,2021 NBA Playoffs - Round 1 - Home Game D,6,1695,1100,-595,52:16.4,4
6/5/2021,20PNR1GD,2021 NBA Playoffs - Round 1 - Home Game D,6,1100,3000,1900,52:46.8,5
6/5/2021,20PNR1GD,2021 NBA Playoffs - Round 1 - Home Game D,6,3000,2340,-660,52:11.0,6
6/5/2021,20PNR1GD,2021 NBA Playoffs - Round 1 - Home Game D,7,23650,38610,14960,16:46.0,1
6/5/2021,20PNR1GD,2021 NBA Playoffs - Round 1 - Home Game D,7,38610,1595,-37015,34:56.5,2
6/5/2021,20PNR1GD,2021 NBA Playoffs - Round 1 - Home Game D,7,1595,1650,55,54:56.8,3
6/5/2021,20PNR1GD,2021 NBA Playoffs - Round 1 - Home Game D,7,1595,1650,55,54:56.8,4
6/5/2021,20PNR1GD,2021 NBA Playoffs - Round 1 - Home Game D,7,1650,1100,-550,52:16.4,5
6/5/2021,20PNR1GD,2021 NBA Playoffs - Round 1 - Home Game D,7,1100,2600,1500,52:46.8,6
6/5/2021,20PNR1GD,2021 NBA Playoffs - Round 1 - Home Game D,7,2600,2030,-570,52:11.0,7
6/5/2021,20PNR1GD,2021 NBA Playoffs - Round 1 - Home Game D,8,18275,32420,14145,16:46.1,1
6/5/2021,20PNR1GD,2021 NBA Playoffs - Round 1 - Home Game D,8,32420,1155,-31265,34:56.5,2
6/5/2021,20PNR1GD,2021 NBA Playoffs - Round 1 - Home Game D,8,1155,1100,-55,52:16.4,3
6/5/2021,20PNR1GD,2021 NBA Playoffs - Round 1 - Home Game D,8,1100,1490,390,52:24.6,4
6/5/2021,20PNR1GD,2021 NBA Playoffs - Round 1 - Home Game D,8,1490,2240,750,52:26.2,5
6/5/2021,20PNR1GD,2021 NBA Playoffs - Round 1 - Home Game D,8,2240,1750,-490,52:11.0,6
6/5/2021,20PNR1GD,2021 NBA Playoffs - Round 1 - Home Game D,9,17630,31260,13630,16:46.1,1
6/5/2021,20PNR1GD,2021 NBA Playoffs - Round 1 - Home Game D,9,31260,1115,-30145,34:56.5,2
6/5/2021,20PNR1GD,2021 NBA Playoffs - Round 1 - Home Game D,9,1115,1100,-15,52:16.4,3
6/5/2021,20PNR1GD,2021 NBA Playoffs - Round 1 - Home Game D,9,1100,1450,350,52:24.6,4
6/5/2021,20PNR1GD,2021 NBA Playoffs - Round 1 - Home Game D,9,1450,2180,730,52:26.2,5
6/5/2021,20PNR1GD,2021 NBA Playoffs - Round 1 - Home Game D,9,2180,1700,-480,52:11.0,6
6/5/2021,20PNR1GD,2021 NBA Playoffs - Round 1 - Home Game D,A,0,16770,16770,32:49.7,1
6/5/2021,20PNR1GD,2021 NBA Playoffs - Round 1 - Home Game D,A,16770,29570,12800,16:46.2,2
6/5/2021,20PNR1GD,2021 NBA Playoffs - Round 1 - Home Game D,A,29570,1055,-28515,34:56.5,3
6/5/2021,20PNR1GD,2021 NBA Playoffs - Round 1 - Home Game D,A,1055,1500,445,52:16.4,4
6/5/2021,20PNR1GD,2021 NBA Playoffs - Round 1 - Home Game D,A,1500,1210,-290,52:17.4,5
6/5/2021,20PNR1GD,2021 NBA Playoffs - Round 1 - Home Game D,A,1210,1490,280,52:24.2,6
6/5/2021,20PNR1GD,2021 NBA Playoffs - Round 1 - Home Game D,A,1490,1370,-120,52:24.6,7
6/5/2021,20PNR1GD,2021 NBA Playoffs - Round 1 - Home Game D,A,1370,2060,690,52:26.2,8
6/5/2021,20PNR1GD,2021 NBA Playoffs - Round 1 - Home Game D,A,2060,1610,-450,52:11.0,9
6/5/2021,20PNR1GD,2021 NBA Playoffs - Round 1 - Home Game D,B,0,16125,16125,32:49.8,1
6/5/2021,20PNR1GD,2021 NBA Playoffs - Round 1 - Home Game D,B,16125,26880,10755,16:46.3,2
6/5/2021,20PNR1GD,2021 NBA Playoffs - Round 1 - Home Game D,B,26880,960,-25920,34:56.5,3
6/5/2021,20PNR1GD,2021 NBA Playoffs - Round 1 - Home Game D,B,960,1100,140,52:16.4,4
6/5/2021,20PNR1GD,2021 NBA Playoffs - Round 1 - Home Game D,B,1100,1170,70,52:17.4,5
6/5/2021,20PNR1GD,2021 NBA Playoffs - Round 1 - Home Game D,B,1170,1450,280,52:24.2,6
6/5/2021,20PNR1GD,2021 NBA Playoffs - Round 1 - Home Game D,B,1450,1250,-200,52:24.6,7
6/5/2021,20PNR1GD,2021 NBA Playoffs - Round 1 - Home Game D,B,1250,1880,630,52:26.2,8
6/5/2021,20PNR1GD,2021 NBA Playoffs - Round 1 - Home Game D,B,1880,1470,-410,52:11.0,9
6/5/2021,20PNR1GD,2021 NBA Playoffs - Round 1 - Home Game D,C,0,15050,15050,32:49.9,1
6/5/2021,20PNR1GD,2021 NBA Playoffs - Round 1 - Home Game D,C,15050,24590,9540,16:46.5,2
6/5/2021,20PNR1GD,2021 NBA Playoffs - Round 1 - Home Game D,C,24590,875,-23715,34:56.5,3
6/5/2021,20PNR1GD,2021 NBA Playoffs - Round 1 - Home Game D,C,875,1100,225,52:16.4,4
6/5/2021,20PNR1GD,2021 NBA Playoffs - Round 1 - Home Game D,C,1100,1110,10,52:17.4,5
6/5/2021,20PNR1GD,2021 NBA Playoffs - Round 1 - Home Game D,C,1110,1370,260,52:24.2,6
6/5/2021,20PNR1GD,2021 NBA Playoffs - Round 1 - Home Game D,C,1370,1150,-220,52:24.6,7
6/5/2021,20PNR1GD,2021 NBA Playoffs - Round 1 - Home Game D,C,1150,1730,580,52:26.2,8
6/5/2021,20PNR1GD,2021 NBA Playoffs - Round 1 - Home Game D,C,1730,1350,-380,52:11.0,9
6/5/2021,20PNR1GD,2021 NBA Playoffs - Round 1 - Home Game D,D,0,14190,14190,32:50.0,1
6/5/2021,20PNR1GD,2021 NBA Playoffs - Round 1 - Home Game D,D,14190,23530,9340,16:46.5,2
6/5/2021,20PNR1GD,2021 NBA Playoffs - Round 1 - Home Game D,D,23530,840,-22690,34:56.5,3
6/5/2021,20PNR1GD,2021 NBA Playoffs - Round 1 - Home Game D,D,840,1100,260,52:16.4,4
6/5/2021,20PNR1GD,2021 NBA Playoffs - Round 1 - Home Game D,D,1100,1010,-90,52:17.4,5
6/5/2021,20PNR1GD,2021 NBA Playoffs - Round 1 - Home Game D,D,1010,1250,240,52:24.2,6
6/5/2021,20PNR1GD,2021 NBA Playoffs - Round 1 - Home Game D,D,1250,1090,-160,52:24.6,7
6/5/2021,20PNR1GD,2021 NBA Playoffs - Round 1 - Home Game D,D,1090,1640,550,52:26.2,8
6/5/2021,20PNR1GD,2021 NBA Playoffs - Round 1 - Home Game D,D,1640,1280,-360,52:11.0,9
6/5/2021,20PNR1GD,2021 NBA Playoffs - Round 1 - Home Game D,E,0,13330,13330,32:50.2,1
6/5/2021,20PNR1GD,2021 NBA Playoffs - Round 1 - Home Game D,E,13330,19750,6420,16:46.6,2
6/5/2021,20PNR1GD,2021 NBA Playoffs - Round 1 - Home Game D,E,19750,705,-19045,34:56.5,3
6/5/2021,20PNR1GD,2021 NBA Playoffs - Round 1 - Home Game D,E,705,1500,795,52:16.4,4
6/5/2021,20PNR1GD,2021 NBA Playoffs - Round 1 - Home Game D,E,1500,920,-580,52:17.4,5
6/5/2021,20PNR1GD,2021 NBA Playoffs - Round 1 - Home Game D,E,920,1150,230,52:24.2,6
6/5/2021,20PNR1GD,2021 NBA Playoffs - Round 1 - Home Game D,E,1150,915,-235,52:24.6,7
6/5/2021,20PNR1GD,2021 NBA Playoffs - Round 1 - Home Game D,E,915,1380,465,52:26.2,8
6/5/2021,20PNR1GD,2021 NBA Playoffs - Round 1 - Home Game D,E,1380,1080,-300,52:11.0,9
6/5/2021,20PNR1GD,2021 NBA Playoffs - Round 1 - Home Game D,F,0,11395,11395,32:50.3,1
6/5/2021,20PNR1GD,2021 NBA Playoffs - Round 1 - Home Game D,F,11395,18710,7315,16:46.7,2
6/5/2021,20PNR1GD,2021 NBA Playoffs - Round 1 - Home Game D,F,18710,665,-18045,34:56.5,3
6/5/2021,20PNR1GD,2021 NBA Playoffs - Round 1 - Home Game D,F,665,1100,435,52:16.4,4
6/5/2021,20PNR1GD,2021 NBA Playoffs - Round 1 - Home Game D,F,1100,880,-220,52:17.4,5
6/5/2021,20PNR1GD,2021 NBA Playoffs - Round 1 - Home Game D,F,880,1090,210,52:24.2,6
6/5/2021,20PNR1GD,2021 NBA Playoffs - Round 1 - Home Game D,F,1090,870,-220,52:24.6,7
6/5/2021,20PNR1GD,2021 NBA Playoffs - Round 1 - Home Game D,F,870,1310,440,52:26.2,8
6/5/2021,20PNR1GD,2021 NBA Playoffs - Round 1 - Home Game D,F,1310,1020,-290,52:11.0,9
6/5/2021,20PNR1GD,2021 NBA Playoffs - Round 1 - Home Game D,G,0,10965,10965,32:50.4,1
6/5/2021,20PNR1GD,2021 NBA Playoffs - Round 1 - Home Game D,G,10965,17090,6125,16:46.8,2
6/5/2021,20PNR1GD,2021 NBA Playoffs - Round 1 - Home Game D,G,17090,610,-16480,34:56.5,3
6/5/2021,20PNR1GD,2021 NBA Playoffs - Round 1 - Home Game D,G,610,1100,490,52:16.4,4
6/5/2021,20PNR1GD,2021 NBA Playoffs - Round 1 - Home Game D,G,1100,740,-360,52:17.4,5
6/5/2021,20PNR1GD,2021 NBA Playoffs - Round 1 - Home Game D,G,740,915,175,52:24.2,6
6/5/2021,20PNR1GD,2021 NBA Playoffs - Round 1 - Home Game D,G,915,795,-120,52:24.6,7
6/5/2021,20PNR1GD,2021 NBA Playoffs - Round 1 - Home Game D,G,795,1200,405,52:26.2,8
6/5/2021,20PNR1GD,2021 NBA Playoffs - Round 1 - Home Game D,G,1200,935,-265,52:11.0,9
6/5/2021,20PNR1GD,2021 NBA Playoffs - Round 1 - Home Game D,H,0,10535,10535,32:50.5,1
6/5/2021,20PNR1GD,2021 NBA Playoffs - Round 1 - Home Game D,H,10535,15770,5235,16:46.9,2
6/5/2021,20PNR1GD,2021 NBA Playoffs - Round 1 - Home Game D,H,15770,560,-15210,34:56.5,3
6/5/2021,20PNR1GD,2021 NBA Playoffs - Round 1 - Home Game D,H,560,1500,940,52:16.4,4
6/5/2021,20PNR1GD,2021 NBA Playoffs - Round 1 - Home Game D,H,1500,700,-800,52:17.4,5
6/5/2021,20PNR1GD,2021 NBA Playoffs - Round 1 - Home Game D,H,700,870,170,52:24.2,6
6/5/2021,20PNR1GD,2021 NBA Playoffs - Round 1 - Home Game D,H,870,730,-140,52:24.6,7
6/5/2021,20PNR1GD,2021 NBA Playoffs - Round 1 - Home Game D,H,730,1100,370,52:26.2,8
6/5/2021,20PNR1GD,2021 NBA Playoffs - Round 1 - Home Game D,H,1100,860,-240,52:11.0,9
6/5/2021,20PNR1GD,2021 NBA Playoffs - Round 1 - Home Game D,I,0,9030,9030,32:50.6,1
6/5/2021,20PNR1GD,2021 NBA Playoffs - Round 1 - Home Game D,I,9030,14180,5150,16:47.0,2
6/5/2021,20PNR1GD,2021 NBA Playoffs - Round 1 - Home Game D,I,14180,505,-13675,34:56.5,3
6/5/2021,20PNR1GD,2021 NBA Playoffs - Round 1 - Home Game D,I,505,1100,595,52:16.4,4
6/5/2021,20PNR1GD,2021 NBA Playoffs - Round 1 - Home Game D,I,1100,640,-460,52:17.4,5
6/5/2021,20PNR1GD,2021 NBA Playoffs - Round 1 - Home Game D,I,640,795,155,52:24.2,6
6/5/2021,20PNR1GD,2021 NBA Playoffs - Round 1 - Home Game D,I,795,660,-135,52:24.6,7
6/5/2021,20PNR1GD,2021 NBA Playoffs - Round 1 - Home Game D,I,660,990,330,52:26.2,8
6/5/2021,20PNR1GD,2021 NBA Playoffs - Round 1 - Home Game D,I,990,770,-220,52:11.0,9
6/5/2021,20PNR1GD,2021 NBA Playoffs - Round 1 - Home Game D,J,0,8385,8385,32:50.7,1
6/5/2021,20PNR1GD,2021 NBA Playoffs - Round 1 - Home Game D,J,8385,13080,4695,16:47.1,2
6/5/2021,20PNR1GD,2021 NBA Playoffs - Round 1 - Home Game D,J,13080,465,-12615,34:56.5,3
6/5/2021,20PNR1GD,2021 NBA Playoffs - Round 1 - Home Game D,J,465,1100,635,52:16.4,4
6/5/2021,20PNR1GD,2021 NBA Playoffs - Round 1 - Home Game D,J,1100,590,-510,52:17.4,5
6/5/2021,20PNR1GD,2021 NBA Playoffs - Round 1 - Home Game D,J,590,730,140,52:24.2,6
6/5/2021,20PNR1GD,2021 NBA Playoffs - Round 1 - Home Game D,J,730,605,-125,52:24.6,7
6/5/2021,20PNR1GD,2021 NBA Playoffs - Round 1 - Home Game D,J,605,910,305,52:26.2,8
6/5/2021,20PNR1GD,2021 NBA Playoffs - Round 1 - Home Game D,J,910,710,-200,52:11.0,9
6/5/2021,20PNR1GD,2021 NBA Playoffs - Round 1 - Home Game D,K,0,6880,6880,32:50.8,1
6/5/2021,20PNR1GD,2021 NBA Playoffs - Round 1 - Home Game D,K,6880,12160,5280,16:47.2,2
6/5/2021,20PNR1GD,2021 NBA Playoffs - Round 1 - Home Game D,K,12160,435,-11725,34:56.5,3
6/5/2021,20PNR1GD,2021 NBA Playoffs - Round 1 - Home Game D,K,435,1500,1065,52:16.4,4
6/5/2021,20PNR1GD,2021 NBA Playoffs - Round 1 - Home Game D,K,1500,530,-970,52:17.4,5
6/5/2021,20PNR1GD,2021 NBA Playoffs - Round 1 - Home Game D,K,530,660,130,52:24.2,6
6/5/2021,20PNR1GD,2021 NBA Playoffs - Round 1 - Home Game D,K,660,565,-95,52:24.6,7
6/5/2021,20PNR1GD,2021 NBA Playoffs - Round 1 - Home Game D,K,565,850,285,52:26.2,8
6/5/2021,20PNR1GD,2021 NBA Playoffs - Round 1 - Home Game D,K,850,665,-185,52:11.0,9
6/5/2021,20PNR1GD,2021 NBA Playoffs - Round 1 - Home Game D,L,0,6450,6450,32:50.9,1
6/5/2021,20PNR1GD,2021 NBA Playoffs - Round 1 - Home Game D,L,6450,11930,5480,16:47.3,2
6/5/2021,20PNR1GD,2021 NBA Playoffs - Round 1 - Home Game D,L,11930,425,-11505,34:56.5,3
6/5/2021,20PNR1GD,2021 NBA Playoffs - Round 1 - Home Game D,L,425,1100,675,52:16.4,4
6/5/2021,20PNR1GD,2021 NBA Playoffs - Round 1 - Home Game D,L,1100,490,-610,52:17.4,5
6/5/2021,20PNR1GD,2021 NBA Playoffs - Round 1 - Home Game D,L,490,605,115,52:24.2,6
6/5/2021,20PNR1GD,2021 NBA Playoffs - Round 1 - Home Game D,L,605,550,-55,52:24.6,7
6/5/2021,20PNR1GD,2021 NBA Playoffs - Round 1 - Home Game D,L,550,825,275,52:26.2,8
6/5/2021,20PNR1GD,2021 NBA Playoffs - Round 1 - Home Game D,L,825,645,-180,52:11.0,9
6/5/2021,20PNR1GD,2021 NBA Playoffs - Round 1 - Home Game D,M,0,6020,6020,32:51.0,1
6/5/2021,20PNR1GD,2021 NBA Playoffs - Round 1 - Home Game D,M,6020,10470,4450,16:47.4,2
6/5/2021,20PNR1GD,2021 NBA Playoffs - Round 1 - Home Game D,M,10470,375,-10095,34:56.5,3
6/5/2021,20PNR1GD,2021 NBA Playoffs - Round 1 - Home Game D,M,375,1100,725,52:16.4,4
6/5/2021,20PNR1GD,2021 NBA Playoffs - Round 1 - Home Game D,M,1100,455,-645,52:17.4,5
6/5/2021,20PNR1GD,2021 NBA Playoffs - Round 1 - Home Game D,M,455,565,110,52:24.2,6
6/5/2021,20PNR1GD,2021 NBA Playoffs - Round 1 - Home Game D,M,565,485,-80,52:24.6,7
6/5/2021,20PNR1GD,2021 NBA Playoffs - Round 1 - Home Game D,M,485,730,245,52:26.2,8
6/5/2021,20PNR1GD,2021 NBA Playoffs - Round 1 - Home Game D,M,730,570,-160,52:11.0,9
6/5/2021,20PNR1GD,2021 NBA Playoffs - Round 1 - Home Game D,N,0,10105,10105,32:51.1,1
6/5/2021,20PNR1GD,2021 NBA Playoffs - Round 1 - Home Game D,N,10105,17290,7185,16:47.4,2
6/5/2021,20PNR1GD,2021 NBA Playoffs - Round 1 - Home Game D,N,17290,615,-16675,34:56.5,3
6/5/2021,20PNR1GD,2021 NBA Playoffs - Round 1 - Home Game D,N,615,1100,485,52:16.4,4
6/5/2021,20PNR1GD,2021 NBA Playoffs - Round 1 - Home Game D,N,1100,445,-655,52:17.4,5
6/5/2021,20PNR1GD,2021 NBA Playoffs - Round 1 - Home Game D,N,445,550,105,52:24.2,6
6/5/2021,20PNR1GD,2021 NBA Playoffs - Round 1 - Home Game D,N,550,805,255,52:24.6,7
6/5/2021,20PNR1GD,2021 NBA Playoffs - Round 1 - Home Game D,N,805,1210,405,52:26.2,8
6/5/2021,20PNR1GD,2021 NBA Playoffs - Round 1 - Home Game D,N,1210,945,-265,52:11.0,9
6/5/2021,20PNR1GD,2021 NBA Playoffs - Round 1 - Home Game D,O,0,9460,9460,32:51.2,1
6/5/2021,20PNR1GD,2021 NBA Playoffs - Round 1 - Home Game D,O,9460,15550,6090,16:47.5,2
6/5/2021,20PNR1GD,2021 NBA Playoffs - Round 1 - Home Game D,O,15550,555,-14995,34:56.5,3
6/5/2021,20PNR1GD,2021 NBA Playoffs - Round 1 - Home Game D,O,555,1100,545,52:16.4,4
6/5/2021,20PNR1GD,2021 NBA Playoffs - Round 1 - Home Game D,O,1100,390,-710,52:17.4,5
6/5/2021,20PNR1GD,2021 NBA Playoffs - Round 1 - Home Game D,O,390,485,95,52:24.2,6
6/5/2021,20PNR1GD,2021 NBA Playoffs - Round 1 - Home Game D,O,485,720,235,52:24.6,7
6/5/2021,20PNR1GD,2021 NBA Playoffs - Round 1 - Home Game D,O,720,1080,360,52:26.2,8
6/5/2021,20PNR1GD,2021 NBA Playoffs - Round 1 - Home Game D,O,1080,840,-240,52:11.0,9
6/5/2021,20PNR1GD,2021 NBA Playoffs - Round 1 - Home Game D,P,0,7740,7740,32:51.3,1
6/5/2021,20PNR1GD,2021 NBA Playoffs - Round 1 - Home Game D,P,7740,13670,5930,16:47.6,2
6/5/2021,20PNR1GD,2021 NBA Playoffs - Round 1 - Home Game D,P,13670,485,-13185,34:56.5,3
6/5/2021,20PNR1GD,2021 NBA Playoffs - Round 1 - Home Game D,P,485,1100,615,52:16.4,4
6/5/2021,20PNR1GD,2021 NBA Playoffs - Round 1 - Home Game D,P,1100,645,-455,52:17.4,5
6/5/2021,20PNR1GD,2021 NBA Playoffs - Round 1 - Home Game D,P,645,805,160,52:24.2,6
6/5/2021,20PNR1GD,2021 NBA Playoffs - Round 1 - Home Game D,P,805,635,-170,52:24.6,7
6/5/2021,20PNR1GD,2021 NBA Playoffs - Round 1 - Home Game D,P,635,955,320,52:26.2,8
6/5/2021,20PNR1GD,2021 NBA Playoffs - Round 1 - Home Game D,P,955,745,-210,52:11.0,9
6/5/2021,20PNR1GD,2021 NBA Playoffs - Round 1 - Home Game D,Q,0,6880,6880,32:51.4,1
6/5/2021,20PNR1GD,2021 NBA Playoffs - Round 1 - Home Game D,Q,6880,10960,4080,16:47.7,2
6/5/2021,20PNR1GD,2021 NBA Playoffs - Round 1 - Home Game D,Q,10960,390,-10570,34:56.5,3
6/5/2021,20PNR1GD,2021 NBA Playoffs - Round 1 - Home Game D,Q,390,1100,710,52:16.4,4
6/5/2021,20PNR1GD,2021 NBA Playoffs - Round 1 - Home Game D,Q,1100,580,-520,52:17.4,5
6/5/2021,20PNR1GD,2021 NBA Playoffs - Round 1 - Home Game D,Q,580,720,140,52:24.2,6
6/5/2021,20PNR1GD,2021 NBA Playoffs - Round 1 - Home Game D,Q,720,510,-210,52:24.6,7
6/5/2021,20PNR1GD,2021 NBA Playoffs - Round 1 - Home Game D,Q,510,765,255,52:26.2,8
6/5/2021,20PNR1GD,2021 NBA Playoffs - Round 1 - Home Game D,Q,765,595,-170,52:11.0,9
6/5/2021,20PNR1GD,2021 NBA Playoffs - Round 1 - Home Game D,R,0,5590,5590,32:51.4,1
6/5/2021,20PNR1GD,2021 NBA Playoffs - Round 1 - Home Game D,R,5590,9740,4150,16:47.8,2
6/5/2021,20PNR1GD,2021 NBA Playoffs - Round 1 - Home Game D,R,9740,345,-9395,34:56.5,3
6/5/2021,20PNR1GD,2021 NBA Playoffs - Round 1 - Home Game D,R,345,1100,755,52:16.4,4
6/5/2021,20PNR1GD,2021 NBA Playoffs - Round 1 - Home Game D,R,1100,510,-590,52:17.4,5
6/5/2021,20PNR1GD,2021 NBA Playoffs - Round 1 - Home Game D,R,510,635,125,52:24.2,6
6/5/2021,20PNR1GD,2021 NBA Playoffs - Round 1 - Home Game D,R,635,455,-180,52:24.6,7
6/5/2021,20PNR1GD,2021 NBA Playoffs - Round 1 - Home Game D,R,455,685,230,52:26.2,8
6/5/2021,20PNR1GD,2021 NBA Playoffs - Round 1 - Home Game D,R,685,535,-150,52:11.0,9
6/5/2021,20PNR1GD,2021 NBA Playoffs - Round 1 - Home Game D,S,0,5590,5590,32:51.6,1
6/5/2021,20PNR1GD,2021 NBA Playoffs - Round 1 - Home Game D,S,5590,9740,4150,16:47.9,2
6/5/2021,20PNR1GD,2021 NBA Playoffs - Round 1 - Home Game D,S,9740,345,-9395,34:56.5,3
6/5/2021,20PNR1GD,2021 NBA Playoffs - Round 1 - Home Game D,S,345,1100,755,52:16.4,4
6/5/2021,20PNR1GD,2021 NBA Playoffs - Round 1 - Home Game D,S,1100,410,-690,52:17.4,5
6/5/2021,20PNR1GD,2021 NBA Playoffs - Round 1 - Home Game D,S,410,510,100,52:24.2,6
6/5/2021,20PNR1GD,2021 NBA Playoffs - Round 1 - Home Game D,S,510,455,-55,52:24.6,7
6/5/2021,20PNR1GD,2021 NBA Playoffs - Round 1 - Home Game D,S,455,685,230,52:26.2,8
6/5/2021,20PNR1GD,2021 NBA Playoffs - Round 1 - Home Game D,S,685,535,-150,52:11.0,9
6/5/2021,20PNR1GD,2021 NBA Playoffs - Round 1 - Home Game D,T,0,4730,4730,32:51.6,1
6/5/2021,20PNR1GD,2021 NBA Playoffs - Round 1 - Home Game D,T,4730,8030,3300,16:47.9,2
6/5/2021,20PNR1GD,2021 NBA Playoffs - Round 1 - Home Game D,T,8030,285,-7745,34:56.5,3
6/5/2021,20PNR1GD,2021 NBA Playoffs - Round 1 - Home Game D,T,285,1100,815,52:16.4,4
6/5/2021,20PNR1GD,2021 NBA Playoffs - Round 1 - Home Game D,T,1100,365,-735,52:17.4,5
6/5/2021,20PNR1GD,2021 NBA Playoffs - Round 1 - Home Game D,T,365,455,90,52:24.2,6
6/5/2021,20PNR1GD,2021 NBA Playoffs - Round 1 - Home Game D,T,455,370,-85,52:24.6,7
6/5/2021,20PNR1GD,2021 NBA Playoffs - Round 1 - Home Game D,T,370,555,185,52:26.2,8
6/5/2021,20PNR1GD,2021 NBA Playoffs - Round 1 - Home Game D,T,555,435,-120,52:11.0,9
6/5/2021,20PNR1GD,2021 NBA Playoffs - Round 1 - Home Game D,U,0,3870,3870,32:51.7,1
6/5/2021,20PNR1GD,2021 NBA Playoffs - Round 1 - Home Game D,U,3870,7130,3260,16:48.0,2
6/5/2021,20PNR1GD,2021 NBA Playoffs - Round 1 - Home Game D,U,7130,255,-6875,34:56.5,3
6/5/2021,20PNR1GD,2021 NBA Playoffs - Round 1 - Home Game D,U,255,1100,845,52:16.4,4
6/5/2021,20PNR1GD,2021 NBA Playoffs - Round 1 - Home Game D,U,1100,365,-735,52:17.4,5
6/5/2021,20PNR1GD,2021 NBA Playoffs - Round 1 - Home Game D,U,365,455,90,52:24.2,6
6/5/2021,20PNR1GD,2021 NBA Playoffs - Round 1 - Home Game D,U,455,335,-120,52:24.6,7
6/5/2021,20PNR1GD,2021 NBA Playoffs - Round 1 - Home Game D,U,335,505,170,52:26.2,8
6/5/2021,20PNR1GD,2021 NBA Playoffs - Round 1 - Home Game D,U,505,395,-110,52:11.0,9
6/5/2021,20PNR1GD,2021 NBA Playoffs - Round 1 - Home Game D,V,0,3440,3440,32:51.8,1
6/5/2021,20PNR1GD,2021 NBA Playoffs - Round 1 - Home Game D,V,3440,6430,2990,16:48.1,2
6/5/2021,20PNR1GD,2021 NBA Playoffs - Round 1 - Home Game D,V,6430,230,-6200,34:56.5,3
6/5/2021,20PNR1GD,2021 NBA Playoffs - Round 1 - Home Game D,V,230,1100,870,52:16.4,4
6/5/2021,20PNR1GD,2021 NBA Playoffs - Round 1 - Home Game D,V,1100,300,-800,52:17.4,5
6/5/2021,20PNR1GD,2021 NBA Playoffs - Round 1 - Home Game D,V,300,370,70,52:24.2,6
6/5/2021,20PNR1GD,2021 NBA Playoffs - Round 1 - Home Game D,V,370,295,-75,52:24.6,7
6/5/2021,20PNR1GD,2021 NBA Playoffs - Round 1 - Home Game D,V,295,445,150,52:26.2,8
6/5/2021,20PNR1GD,2021 NBA Playoffs - Round 1 - Home Game D,V,445,345,-100,52:11.0,9
6/5/2021,20PNR1GD,2021 NBA Playoffs - Round 1 - Home Game D,W,0,3010,3010,32:51.9,1
6/5/2021,20PNR1GD,2021 NBA Playoffs - Round 1 - Home Game D,W,3010,6030,3020,16:48.2,2
6/5/2021,20PNR1GD,2021 NBA Playoffs - Round 1 - Home Game D,W,6030,215,-5815,34:56.5,3
6/5/2021,20PNR1GD,2021 NBA Playoffs - Round 1 - Home Game D,W,215,1100,885,52:16.4,4
6/5/2021,20PNR1GD,2021 NBA Playoffs - Round 1 - Home Game D,W,1100,265,-835,52:17.4,5
6/5/2021,20PNR1GD,2021 NBA Playoffs - Round 1 - Home Game D,W,265,335,70,52:24.2,6
6/5/2021,20PNR1GD,2021 NBA Playoffs - Round 1 - Home Game D,W,335,280,-55,52:24.6,7
6/5/2021,20PNR1GD,2021 NBA Playoffs - Round 1 - Home Game D,W,280,420,140,52:26.2,8
6/5/2021,20PNR1GD,2021 NBA Playoffs - Round 1 - Home Game D,W,420,330,-90,52:11.0,9
6/5/2021,20PNR1GD,2021 NBA Playoffs - Round 1 - Home Game D,X,0,2795,2795,32:52.0,1
6/5/2021,20PNR1GD,2021 NBA Playoffs - Round 1 - Home Game D,X,2795,5370,2575,16:48.3,2
6/5/2021,20PNR1GD,2021 NBA Playoffs - Round 1 - Home Game D,X,5370,190,-5180,34:56.5,3
6/5/2021,20PNR1GD,2021 NBA Playoffs - Round 1 - Home Game D,X,190,1100,910,52:16.4,4
6/5/2021,20PNR1GD,2021 NBA Playoffs - Round 1 - Home Game D,X,1100,755,-345,52:17.4,5
6/5/2021,20PNR1GD,2021 NBA Playoffs - Round 1 - Home Game D,X,755,940,185,52:24.2,6
6/5/2021,20PNR1GD,2021 NBA Playoffs - Round 1 - Home Game D,X,940,250,-690,52:24.6,7
6/5/2021,20PNR1GD,2021 NBA Playoffs - Round 1 - Home Game D,X,250,375,125,52:26.2,8
6/5/2021,20PNR1GD,2021 NBA Playoffs - Round 1 - Home Game D,X,375,295,-80,52:11.0,9
6/5/2021,20PNR1GD,2021 NBA Playoffs - Round 1 - Home Game D,Y,0,2795,2795,32:52.1,1
6/5/2021,20PNR1GD,2021 NBA Playoffs - Round 1 - Home Game D,Y,2795,5220,2425,16:48.4,2
6/5/2021,20PNR1GD,2021 NBA Playoffs - Round 1 - Home Game D,Y,5220,185,-5035,34:56.5,3
6/5/2021,20PNR1GD,2021 NBA Playoffs - Round 1 - Home Game D,Y,185,1100,915,52:16.4,4
6/5/2021,20PNR1GD,2021 NBA Playoffs - Round 1 - Home Game D,Y,1100,240,-860,52:24.6,5
6/5/2021,20PNR1GD,2021 NBA Playoffs - Round 1 - Home Game D,Y,240,360,120,52:26.2,6
6/5/2021,20PNR1GD,2021 NBA Playoffs - Round 1 - Home Game D,Y,360,280,-80,52:11.0,7
6/5/2021,20PNR1GD,2021 NBA Playoffs - Round 1 - Home Game D,Z,0,999999,999999,32:52.2,1
6/5/2021,20PNR1GD,2021 NBA Playoffs - Round 1 - Home Game D,Z,999999,20190,-979809,16:48.5,2
6/5/2021,20PNR1GD,2021 NBA Playoffs - Round 1 - Home Game D,Z,20190,720,-19470,34:56.5,3
6/5/2021,20PNR1GD,2021 NBA Playoffs - Round 1 - Home Game D,Z,720,1100,380,52:16.4,4
6/5/2021,20PNR1GD,2021 NBA Playoffs - Round 1 - Home Game D,Z,1100,940,-160,52:24.6,5
6/5/2021,20PNR1GD,2021 NBA Playoffs - Round 1 - Home Game D,Z,940,1410,470,52:26.2,6
6/5/2021,20PNR1GD,2021 NBA Playoffs - Round 1 - Home Game D,Z,1410,1100,-310,52:11.0,7
6/5/2021,20PNR1VD,2021 NBA Playoffs - Round 1 - Home Game D,1,0,6685,6685,22:07.6,1
6/5/2021,20PNR1VD,2021 NBA Playoffs - Round 1 - Home Game D,1,6685,1100,-5585,52:21.8,2
6/5/2021,20PNR1VD,2021 NBA Playoffs - Round 1 - Home Game D,1,1100,7000,5900,53:13.6,3
6/5/2021,20PNR1VD,2021 NBA Playoffs - Round 1 - Home Game D,2,0,6685,6685,22:07.7,1
6/5/2021,20PNR1VD,2021 NBA Playoffs - Round 1 - Home Game D,2,6685,1100,-5585,52:21.8,2
6/5/2021,20PNR1VD,2021 NBA Playoffs - Round 1 - Home Game D,2,1100,7000,5900,53:13.6,3
6/5/2021,20PNR1VD,2021 NBA Playoffs - Round 1 - Home Game D,3,0,6685,6685,22:07.8,1
6/5/2021,20PNR1VD,2021 NBA Playoffs - Round 1 - Home Game D,3,6685,1100,-5585,52:21.8,2
6/5/2021,20PNR1VD,2021 NBA Playoffs - Round 1 - Home Game D,3,1100,7000,5900,53:13.6,3
6/5/2021,20PNR1VD,2021 NBA Playoffs - Round 1 - Home Game D,4,0,4860,4860,22:07.9,1
6/5/2021,20PNR1VD,2021 NBA Playoffs - Round 1 - Home Game D,4,4860,1100,-3760,52:21.8,2
6/5/2021,20PNR1VD,2021 NBA Playoffs - Round 1 - Home Game D,4,1100,7000,5900,53:13.6,3
6/5/2021,20PNR1VD,2021 NBA Playoffs - Round 1 - Home Game D,5,0,2265,2265,22:08.0,1
6/5/2021,20PNR1VD,2021 NBA Playoffs - Round 1 - Home Game D,5,2265,1100,-1165,52:21.8,2
6/5/2021,20PNR1VD,2021 NBA Playoffs - Round 1 - Home Game D,5,1100,1400,300,53:13.6,3
6/5/2021,20PNR1VD,2021 NBA Playoffs - Round 1 - Home Game D,6,0,1695,1695,22:08.1,1
6/5/2021,20PNR1VD,2021 NBA Playoffs - Round 1 - Home Game D,6,1695,1100,-595,52:21.8,2
6/5/2021,20PNR1VD,2021 NBA Playoffs - Round 1 - Home Game D,6,1100,1200,100,53:13.6,3
6/5/2021,20PNR1VD,2021 NBA Playoffs - Round 1 - Home Game D,7,1650,1100,-550,52:21.8,1
6/5/2021,20PNR1VD,2021 NBA Playoffs - Round 1 - Home Game D,7,1100,1500,400,52:50.3,2
6/5/2021,20PNR1VD,2021 NBA Playoffs - Round 1 - Home Game D,7,1500,1100,-400,53:13.6,3
6/5/2021,20PNR1VD,2021 NBA Playoffs - Round 1 - Home Game D,8,1155,1100,-55,52:21.8,1
6/5/2021,20PNR1VD,2021 NBA Playoffs - Round 1 - Home Game D,8,1100,800,-300,52:50.3,2
6/5/2021,20PNR1VD,2021 NBA Playoffs - Round 1 - Home Game D,9,1115,1500,385,52:21.8,1
6/5/2021,20PNR1VD,2021 NBA Playoffs - Round 1 - Home Game D,9,1500,765,-735,52:50.3,2
6/5/2021,20PNR1VD,2021 NBA Playoffs - Round 1 - Home Game D,A,0,1055,1055,22:08.2,1
6/5/2021,20PNR1VD,2021 NBA Playoffs - Round 1 - Home Game D,A,1055,1100,45,52:21.8,2
6/5/2021,20PNR1VD,2021 NBA Playoffs - Round 1 - Home Game D,A,1100,1210,110,52:39.4,3
6/5/2021,20PNR1VD,2021 NBA Playoffs - Round 1 - Home Game D,A,1210,765,-445,52:10.9,4
6/5/2021,20PNR1VD,2021 NBA Playoffs - Round 1 - Home Game D,A,765,800,35,52:11.9,5
6/5/2021,20PNR1VD,2021 NBA Playoffs - Round 1 - Home Game D,A,800,725,-75,52:50.3,6
6/5/2021,20PNR1VD,2021 NBA Playoffs - Round 1 - Home Game D,B,0,960,960,22:08.3,1
6/5/2021,20PNR1VD,2021 NBA Playoffs - Round 1 - Home Game D,B,960,1100,140,52:21.8,2
6/5/2021,20PNR1VD,2021 NBA Playoffs - Round 1 - Home Game D,B,1100,1170,70,52:39.4,3
6/5/2021,20PNR1VD,2021 NBA Playoffs - Round 1 - Home Game D,B,1170,735,-435,52:10.9,4
6/5/2021,20PNR1VD,2021 NBA Playoffs - Round 1 - Home Game D,B,735,765,30,52:11.9,5
6/5/2021,20PNR1VD,2021 NBA Playoffs - Round 1 - Home Game D,B,765,665,-100,52:50.3,6
6/5/2021,20PNR1VD,2021 NBA Playoffs - Round 1 - Home Game D,C,0,875,875,22:08.4,1
6/5/2021,20PNR1VD,2021 NBA Playoffs - Round 1 - Home Game D,C,875,1100,225,52:21.8,2
6/5/2021,20PNR1VD,2021 NBA Playoffs - Round 1 - Home Game D,C,1100,1110,10,52:39.4,3
6/5/2021,20PNR1VD,2021 NBA Playoffs - Round 1 - Home Game D,C,1110,695,-415,52:10.9,4
6/5/2021,20PNR1VD,2021 NBA Playoffs - Round 1 - Home Game D,C,695,725,30,52:11.9,5
6/5/2021,20PNR1VD,2021 NBA Playoffs - Round 1 - Home Game D,C,725,625,-100,52:50.3,6
6/5/2021,20PNR1VD,2021 NBA Playoffs - Round 1 - Home Game D,D,0,840,840,22:08.5,1
6/5/2021,20PNR1VD,2021 NBA Playoffs - Round 1 - Home Game D,D,840,1500,660,52:21.8,2
6/5/2021,20PNR1VD,2021 NBA Playoffs - Round 1 - Home Game D,D,1500,1010,-490,52:39.4,3
6/5/2021,20PNR1VD,2021 NBA Playoffs - Round 1 - Home Game D,D,1010,630,-380,52:10.9,4
6/5/2021,20PNR1VD,2021 NBA Playoffs - Round 1 - Home Game D,D,630,665,35,52:11.9,5
6/5/2021,20PNR1VD,2021 NBA Playoffs - Round 1 - Home Game D,D,665,605,-60,52:50.3,6
6/5/2021,20PNR1VD,2021 NBA Playoffs - Round 1 - Home Game D,E,0,705,705,22:08.7,1
6/5/2021,20PNR1VD,2021 NBA Playoffs - Round 1 - Home Game D,E,705,1100,395,52:21.8,2
6/5/2021,20PNR1VD,2021 NBA Playoffs - Round 1 - Home Game D,E,1100,920,-180,52:39.4,3
6/5/2021,20PNR1VD,2021 NBA Playoffs - Round 1 - Home Game D,E,920,585,-335,52:10.9,4
6/5/2021,20PNR1VD,2021 NBA Playoffs - Round 1 - Home Game D,E,585,625,40,52:11.9,5
6/5/2021,20PNR1VD,2021 NBA Playoffs - Round 1 - Home Game D,E,625,520,-105,52:50.3,6
6/5/2021,20PNR1VD,2021 NBA Playoffs - Round 1 - Home Game D,F,0,665,665,22:08.8,1
6/5/2021,20PNR1VD,2021 NBA Playoffs - Round 1 - Home Game D,F,665,1100,435,52:21.8,2
6/5/2021,20PNR1VD,2021 NBA Playoffs - Round 1 - Home Game D,F,1100,880,-220,52:39.4,3
6/5/2021,20PNR1VD,2021 NBA Playoffs - Round 1 - Home Game D,F,880,560,-320,52:10.9,4
6/5/2021,20PNR1VD,2021 NBA Playoffs - Round 1 - Home Game D,F,560,605,45,52:11.9,5
6/5/2021,20PNR1VD,2021 NBA Playoffs - Round 1 - Home Game D,F,605,490,-115,52:50.3,6
6/5/2021,20PNR1VD,2021 NBA Playoffs - Round 1 - Home Game D,G,0,610,610,22:08.9,1
6/5/2021,20PNR1VD,2021 NBA Playoffs - Round 1 - Home Game D,G,610,1100,490,52:21.8,2
6/5/2021,20PNR1VD,2021 NBA Playoffs - Round 1 - Home Game D,G,1100,740,-360,52:39.4,3
6/5/2021,20PNR1VD,2021 NBA Playoffs - Round 1 - Home Game D,G,740,475,-265,52:10.9,4
6/5/2021,20PNR1VD,2021 NBA Playoffs - Round 1 - Home Game D,G,475,520,45,52:11.9,5
6/5/2021,20PNR1VD,2021 NBA Playoffs - Round 1 - Home Game D,G,520,460,-60,52:50.3,6
6/5/2021,20PNR1VD,2021 NBA Playoffs - Round 1 - Home Game D,H,0,560,560,22:08.9,1
6/5/2021,20PNR1VD,2021 NBA Playoffs - Round 1 - Home Game D,H,560,1100,540,52:21.8,2
6/5/2021,20PNR1VD,2021 NBA Playoffs - Round 1 - Home Game D,H,1100,700,-400,52:39.4,3
6/5/2021,20PNR1VD,2021 NBA Playoffs - Round 1 - Home Game D,H,700,445,-255,52:10.9,4
6/5/2021,20PNR1VD,2021 NBA Playoffs - Round 1 - Home Game D,H,445,490,45,52:11.9,5
6/5/2021,20PNR1VD,2021 NBA Playoffs - Round 1 - Home Game D,H,490,425,-65,52:50.3,6
6/5/2021,20PNR1VD,2021 NBA Playoffs - Round 1 - Home Game D,I,0,505,505,22:09.1,1
6/5/2021,20PNR1VD,2021 NBA Playoffs - Round 1 - Home Game D,I,505,1500,995,52:21.8,2
6/5/2021,20PNR1VD,2021 NBA Playoffs - Round 1 - Home Game D,I,1500,640,-860,52:39.4,3
6/5/2021,20PNR1VD,2021 NBA Playoffs - Round 1 - Home Game D,I,640,415,-225,52:10.9,4
6/5/2021,20PNR1VD,2021 NBA Playoffs - Round 1 - Home Game D,I,415,460,45,52:11.9,5
6/5/2021,20PNR1VD,2021 NBA Playoffs - Round 1 - Home Game D,I,460,395,-65,52:50.3,6
6/5/2021,20PNR1VD,2021 NBA Playoffs - Round 1 - Home Game D,J,0,465,465,22:09.2,1
6/5/2021,20PNR1VD,2021 NBA Playoffs - Round 1 - Home Game D,J,465,1100,635,52:21.8,2
6/5/2021,20PNR1VD,2021 NBA Playoffs - Round 1 - Home Game D,J,1100,590,-510,52:39.4,3
6/5/2021,20PNR1VD,2021 NBA Playoffs - Round 1 - Home Game D,J,590,380,-210,52:10.9,4
6/5/2021,20PNR1VD,2021 NBA Playoffs - Round 1 - Home Game D,J,380,425,45,52:11.9,5
6/5/2021,20PNR1VD,2021 NBA Playoffs - Round 1 - Home Game D,J,425,370,-55,52:50.3,6
6/5/2021,20PNR1VD,2021 NBA Playoffs - Round 1 - Home Game D,K,0,435,435,22:09.3,1
6/5/2021,20PNR1VD,2021 NBA Playoffs - Round 1 - Home Game D,K,435,1100,665,52:21.8,2
6/5/2021,20PNR1VD,2021 NBA Playoffs - Round 1 - Home Game D,K,1100,530,-570,52:39.4,3
6/5/2021,20PNR1VD,2021 NBA Playoffs - Round 1 - Home Game D,K,530,350,-180,52:10.9,4
6/5/2021,20PNR1VD,2021 NBA Playoffs - Round 1 - Home Game D,K,350,395,45,52:11.9,5
6/5/2021,20PNR1VD,2021 NBA Playoffs - Round 1 - Home Game D,K,395,350,-45,52:50.3,6
6/5/2021,20PNR1VD,2021 NBA Playoffs - Round 1 - Home Game D,L,0,425,425,22:09.4,1
6/5/2021,20PNR1VD,2021 NBA Playoffs - Round 1 - Home Game D,L,425,1100,675,52:21.8,2
6/5/2021,20PNR1VD,2021 NBA Playoffs - Round 1 - Home Game D,L,1100,490,-610,52:39.4,3
6/5/2021,20PNR1VD,2021 NBA Playoffs - Round 1 - Home Game D,L,490,325,-165,52:10.9,4
6/5/2021,20PNR1VD,2021 NBA Playoffs - Round 1 - Home Game D,L,325,370,45,52:11.9,5
6/5/2021,20PNR1VD,2021 NBA Playoffs - Round 1 - Home Game D,L,370,340,-30,52:50.3,6
6/5/2021,20PNR1VD,2021 NBA Playoffs - Round 1 - Home Game D,M,0,375,375,22:09.5,1
6/5/2021,20PNR1VD,2021 NBA Playoffs - Round 1 - Home Game D,M,375,1500,1125,52:21.8,2
6/5/2021,20PNR1VD,2021 NBA Playoffs - Round 1 - Home Game D,M,1500,455,-1045,52:39.4,3
6/5/2021,20PNR1VD,2021 NBA Playoffs - Round 1 - Home Game D,M,455,305,-150,52:10.9,4
6/5/2021,20PNR1VD,2021 NBA Playoffs - Round 1 - Home Game D,M,305,350,45,52:11.9,5
6/5/2021,20PNR1VD,2021 NBA Playoffs - Round 1 - Home Game D,M,350,315,-35,52:50.3,6
6/5/2021,20PNR1VD,2021 NBA Playoffs - Round 1 - Home Game D,N,0,615,615,22:09.6,1
6/5/2021,20PNR1VD,2021 NBA Playoffs - Round 1 - Home Game D,N,615,1100,485,52:21.8,2
6/5/2021,20PNR1VD,2021 NBA Playoffs - Round 1 - Home Game D,N,1100,445,-655,52:39.4,3
6/5/2021,20PNR1VD,2021 NBA Playoffs - Round 1 - Home Game D,N,445,295,-150,52:10.9,4
6/5/2021,20PNR1VD,2021 NBA Playoffs - Round 1 - Home Game D,N,295,340,45,52:11.9,5
6/5/2021,20PNR1VD,2021 NBA Playoffs - Round 1 - Home Game D,N,340,475,135,52:50.3,6
6/5/2021,20PNR1VD,2021 NBA Playoffs - Round 1 - Home Game D,O,0,555,555,22:09.7,1
6/5/2021,20PNR1VD,2021 NBA Playoffs - Round 1 - Home Game D,O,555,1100,545,52:21.8,2
6/5/2021,20PNR1VD,2021 NBA Playoffs - Round 1 - Home Game D,O,1100,390,-710,52:39.4,3
6/5/2021,20PNR1VD,2021 NBA Playoffs - Round 1 - Home Game D,O,390,265,-125,52:10.9,4
6/5/2021,20PNR1VD,2021 NBA Playoffs - Round 1 - Home Game D,O,265,315,50,52:11.9,5
6/5/2021,20PNR1VD,2021 NBA Playoffs - Round 1 - Home Game D,O,315,430,115,52:50.3,6
6/5/2021,20PNR1VD,2021 NBA Playoffs - Round 1 - Home Game D,P,0,485,485,22:09.8,1
6/5/2021,20PNR1VD,2021 NBA Playoffs - Round 1 - Home Game D,P,485,1100,615,52:21.8,2
6/5/2021,20PNR1VD,2021 NBA Playoffs - Round 1 - Home Game D,P,1100,645,-455,52:39.4,3
6/5/2021,20PNR1VD,2021 NBA Playoffs - Round 1 - Home Game D,P,645,435,-210,52:10.9,4
6/5/2021,20PNR1VD,2021 NBA Playoffs - Round 1 - Home Game D,P,435,475,40,52:11.9,5
6/5/2021,20PNR1VD,2021 NBA Playoffs - Round 1 - Home Game D,P,475,385,-90,52:50.3,6
6/5/2021,20PNR1VD,2021 NBA Playoffs - Round 1 - Home Game D,Q,0,390,390,22:09.9,1
6/5/2021,20PNR1VD,2021 NBA Playoffs - Round 1 - Home Game D,Q,390,1100,710,52:21.8,2
6/5/2021,20PNR1VD,2021 NBA Playoffs - Round 1 - Home Game D,Q,1100,580,-520,52:39.4,3
6/5/2021,20PNR1VD,2021 NBA Playoffs - Round 1 - Home Game D,Q,580,390,-190,52:10.9,4
6/5/2021,20PNR1VD,2021 NBA Playoffs - Round 1 - Home Game D,Q,390,430,40,52:11.9,5
6/5/2021,20PNR1VD,2021 NBA Playoffs - Round 1 - Home Game D,Q,430,310,-120,52:50.3,6
6/5/2021,20PNR1VD,2021 NBA Playoffs - Round 1 - Home Game D,R,0,345,345,22:10.0,1
6/5/2021,20PNR1VD,2021 NBA Playoffs - Round 1 - Home Game D,R,345,1100,755,52:21.8,2
6/5/2021,20PNR1VD,2021 NBA Playoffs - Round 1 - Home Game D,R,1100,510,-590,52:39.4,3
6/5/2021,20PNR1VD,2021 NBA Playoffs - Round 1 - Home Game D,R,510,340,-170,52:10.9,4
6/5/2021,20PNR1VD,2021 NBA Playoffs - Round 1 - Home Game D,R,340,385,45,52:11.9,5
6/5/2021,20PNR1VD,2021 NBA Playoffs - Round 1 - Home Game D,R,385,280,-105,52:50.3,6
6/5/2021,20PNR1VD,2021 NBA Playoffs - Round 1 - Home Game D,S,0,345,345,22:10.1,1
6/5/2021,20PNR1VD,2021 NBA Playoffs - Round 1 - Home Game D,S,345,1100,755,52:21.8,2
6/5/2021,20PNR1VD,2021 NBA Playoffs - Round 1 - Home Game D,S,1100,410,-690,52:39.4,3
6/5/2021,20PNR1VD,2021 NBA Playoffs - Round 1 - Home Game D,S,410,275,-135,52:10.9,4
6/5/2021,20PNR1VD,2021 NBA Playoffs - Round 1 - Home Game D,S,275,310,35,52:11.9,5
6/5/2021,20PNR1VD,2021 NBA Playoffs - Round 1 - Home Game D,S,310,280,-30,52:50.3,6
6/5/2021,20PNR1VD,2021 NBA Playoffs - Round 1 - Home Game D,T,0,285,285,22:10.2,1
6/5/2021,20PNR1VD,2021 NBA Playoffs - Round 1 - Home Game D,T,285,1100,815,52:21.8,2
6/5/2021,20PNR1VD,2021 NBA Playoffs - Round 1 - Home Game D,T,1100,365,-735,52:39.4,3
6/5/2021,20PNR1VD,2021 NBA Playoffs - Round 1 - Home Game D,T,365,245,-120,52:10.9,4
6/5/2021,20PNR1VD,2021 NBA Playoffs - Round 1 - Home Game D,T,245,280,35,52:11.9,5
6/5/2021,20PNR1VD,2021 NBA Playoffs - Round 1 - Home Game D,T,280,255,-25,52:50.3,6
6/5/2021,20PNR1VD,2021 NBA Playoffs - Round 1 - Home Game D,U,0,255,255,22:10.4,1
6/5/2021,20PNR1VD,2021 NBA Playoffs - Round 1 - Home Game D,U,255,1100,845,52:21.8,2
6/5/2021,20PNR1VD,2021 NBA Playoffs - Round 1 - Home Game D,U,1100,365,-735,52:39.4,3
6/5/2021,20PNR1VD,2021 NBA Playoffs - Round 1 - Home Game D,U,365,245,-120,52:10.9,4
6/5/2021,20PNR1VD,2021 NBA Playoffs - Round 1 - Home Game D,U,245,280,35,52:11.9,5
6/5/2021,20PNR1VD,2021 NBA Playoffs - Round 1 - Home Game D,U,280,220,-60,52:50.3,6
6/5/2021,20PNR1VD,2021 NBA Playoffs - Round 1 - Home Game D,V,0,230,230,22:10.5,1
6/5/2021,20PNR1VD,2021 NBA Playoffs - Round 1 - Home Game D,V,230,1100,870,52:21.8,2
6/5/2021,20PNR1VD,2021 NBA Playoffs - Round 1 - Home Game D,V,1100,300,-800,52:39.4,3
6/5/2021,20PNR1VD,2021 NBA Playoffs - Round 1 - Home Game D,V,300,210,-90,52:10.9,4
6/5/2021,20PNR1VD,2021 NBA Playoffs - Round 1 - Home Game D,V,210,255,45,52:11.9,5
6/5/2021,20PNR1VD,2021 NBA Playoffs - Round 1 - Home Game D,V,255,200,-55,52:50.3,6
6/5/2021,20PNR1VD,2021 NBA Playoffs - Round 1 - Home Game D,W,0,215,215,22:10.6,1
6/5/2021,20PNR1VD,2021 NBA Playoffs - Round 1 - Home Game D,W,215,1100,885,52:21.8,2
6/5/2021,20PNR1VD,2021 NBA Playoffs - Round 1 - Home Game D,W,1100,265,-835,52:39.4,3
6/5/2021,20PNR1VD,2021 NBA Playoffs - Round 1 - Home Game D,W,265,185,-80,52:10.9,4
6/5/2021,20PNR1VD,2021 NBA Playoffs - Round 1 - Home Game D,W,185,220,35,52:11.9,5
6/5/2021,20PNR1VD,2021 NBA Playoffs - Round 1 - Home Game D,W,220,185,-35,52:50.3,6
6/5/2021,20PNR1VD,2021 NBA Playoffs - Round 1 - Home Game D,X,0,190,190,22:10.7,1
6/5/2021,20PNR1VD,2021 NBA Playoffs - Round 1 - Home Game D,X,190,1100,910,52:21.8,2
6/5/2021,20PNR1VD,2021 NBA Playoffs - Round 1 - Home Game D,X,1100,755,-345,52:39.4,3
6/5/2021,20PNR1VD,2021 NBA Playoffs - Round 1 - Home Game D,X,755,460,-295,52:10.9,4
6/5/2021,20PNR1VD,2021 NBA Playoffs - Round 1 - Home Game D,X,460,500,40,52:11.9,5
6/5/2021,20PNR1VD,2021 NBA Playoffs - Round 1 - Home Game D,X,500,170,-330,52:50.3,6
6/5/2021,20PNR1VD,2021 NBA Playoffs - Round 1 - Home Game D,Y,0,185,185,22:10.8,1
6/5/2021,20PNR1VD,2021 NBA Playoffs - Round 1 - Home Game D,Y,185,1100,915,52:21.8,2
6/5/2021,20PNR1VD,2021 NBA Playoffs - Round 1 - Home Game D,Y,1100,155,-945,52:50.3,3
6/5/2021,20PNR1VD,2021 NBA Playoffs - Round 1 - Home Game D,Z,0,720,720,22:10.9,1
6/5/2021,20PNR1VD,2021 NBA Playoffs - Round 1 - Home Game D,Z,720,1100,380,52:21.8,2
6/5/2021,20PNR1VD,2021 NBA Playoffs - Round 1 - Home Game D,Z,1100,500,-600,52:50.3,3
6/5/2021,20PNR2GA,2021 NBA Playoffs - Round 2 - Home Game A,1,0,236500,236500,32:52.3,1
6/5/2021,20PNR2GA,2021 NBA Playoffs - Round 2 - Home Game A,1,236500,157500,-79000,16:48.6,2
6/5/2021,20PNR2GA,2021 NBA Playoffs - Round 2 - Home Game A,1,157500,7315,-150185,34:56.5,3
6/5/2021,20PNR2GA,2021 NBA Playoffs - Round 2 - Home Game A,2,0,98900,98900,32:52.4,1
6/5/2021,20PNR2GA,2021 NBA Playoffs - Round 2 - Home Game A,2,98900,7315,-91585,34:56.5,2
6/5/2021,20PNR2GA,2021 NBA Playoffs - Round 2 - Home Game A,3,0,85979,85979,32:52.5,1
6/5/2021,20PNR2GA,2021 NBA Playoffs - Round 2 - Home Game A,3,85979,157500,71521,16:48.7,2
6/5/2021,20PNR2GA,2021 NBA Playoffs - Round 2 - Home Game A,3,157500,7315,-150185,34:56.5,3
6/5/2021,20PNR2GA,2021 NBA Playoffs - Round 2 - Home Game A,4,0,47300,47300,32:52.6,1
6/5/2021,20PNR2GA,2021 NBA Playoffs - Round 2 - Home Game A,4,47300,114540,67240,16:48.8,2
6/5/2021,20PNR2GA,2021 NBA Playoffs - Round 2 - Home Game A,4,114540,5320,-109220,34:56.5,3
6/5/2021,20PNR2GA,2021 NBA Playoffs - Round 2 - Home Game A,5,0,43000,43000,32:52.7,1
6/5/2021,20PNR2GA,2021 NBA Playoffs - Round 2 - Home Game A,5,43000,59120,16120,16:48.9,2
6/5/2021,20PNR2GA,2021 NBA Playoffs - Round 2 - Home Game A,5,59120,2920,-56200,34:56.5,3
6/5/2021,20PNR2GA,2021 NBA Playoffs - Round 2 - Home Game A,5,2920,2710,-210,54:56.8,4
6/5/2021,20PNR2GA,2021 NBA Playoffs - Round 2 - Home Game A,5,2920,2710,-210,54:56.8,5
6/5/2021,20PNR2GA,2021 NBA Playoffs - Round 2 - Home Game A,6,0,30100,30100,32:52.8,1
6/5/2021,20PNR2GA,2021 NBA Playoffs - Round 2 - Home Game A,6,30100,41100,11000,16:49.0,2
6/5/2021,20PNR2GA,2021 NBA Playoffs - Round 2 - Home Game A,6,41100,2030,-39070,34:56.5,3
6/5/2021,20PNR2GA,2021 NBA Playoffs - Round 2 - Home Game A,7,23650,38610,14960,16:49.1,1
6/5/2021,20PNR2GA,2021 NBA Playoffs - Round 2 - Home Game A,7,38610,1905,-36705,34:56.5,2
6/5/2021,20PNR2GA,2021 NBA Playoffs - Round 2 - Home Game A,7,1905,1975,70,54:56.8,3
6/5/2021,20PNR2GA,2021 NBA Playoffs - Round 2 - Home Game A,7,1905,1975,70,54:56.8,4
6/5/2021,20PNR2GA,2021 NBA Playoffs - Round 2 - Home Game A,8,18275,32420,14145,16:49.2,1
6/5/2021,20PNR2GA,2021 NBA Playoffs - Round 2 - Home Game A,8,32420,1385,-31035,34:56.5,2
6/5/2021,20PNR2GA,2021 NBA Playoffs - Round 2 - Home Game A,9,17630,31260,13630,16:49.3,1
6/5/2021,20PNR2GA,2021 NBA Playoffs - Round 2 - Home Game A,9,31260,1335,-29925,34:56.5,2
6/5/2021,20PNR2GA,2021 NBA Playoffs - Round 2 - Home Game A,A,0,16770,16770,32:52.9,1
6/5/2021,20PNR2GA,2021 NBA Playoffs - Round 2 - Home Game A,A,16770,29570,12800,16:49.4,2
6/5/2021,20PNR2GA,2021 NBA Playoffs - Round 2 - Home Game A,A,29570,1260,-28310,34:56.5,3
6/5/2021,20PNR2GA,2021 NBA Playoffs - Round 2 - Home Game A,B,0,16125,16125,32:53.0,1
6/5/2021,20PNR2GA,2021 NBA Playoffs - Round 2 - Home Game A,B,16125,26880,10755,16:49.4,2
6/5/2021,20PNR2GA,2021 NBA Playoffs - Round 2 - Home Game A,B,26880,1145,-25735,34:56.5,3
6/5/2021,20PNR2GA,2021 NBA Playoffs - Round 2 - Home Game A,C,0,15050,15050,32:53.1,1
6/5/2021,20PNR2GA,2021 NBA Playoffs - Round 2 - Home Game A,C,15050,24590,9540,16:49.5,2
6/5/2021,20PNR2GA,2021 NBA Playoffs - Round 2 - Home Game A,C,24590,1050,-23540,34:56.5,3
6/5/2021,20PNR2GA,2021 NBA Playoffs - Round 2 - Home Game A,D,0,14190,14190,32:53.2,1
6/5/2021,20PNR2GA,2021 NBA Playoffs - Round 2 - Home Game A,D,14190,23530,9340,16:49.6,2
6/5/2021,20PNR2GA,2021 NBA Playoffs - Round 2 - Home Game A,D,23530,1005,-22525,34:56.5,3
6/5/2021,20PNR2GA,2021 NBA Playoffs - Round 2 - Home Game A,E,0,13330,13330,32:53.2,1
6/5/2021,20PNR2GA,2021 NBA Playoffs - Round 2 - Home Game A,E,13330,19750,6420,16:49.7,2
6/5/2021,20PNR2GA,2021 NBA Playoffs - Round 2 - Home Game A,E,19750,845,-18905,34:56.5,3
6/5/2021,20PNR2GA,2021 NBA Playoffs - Round 2 - Home Game A,F,0,11395,11395,32:53.3,1
6/5/2021,20PNR2GA,2021 NBA Playoffs - Round 2 - Home Game A,F,11395,18710,7315,16:49.8,2
6/5/2021,20PNR2GA,2021 NBA Playoffs - Round 2 - Home Game A,F,18710,800,-17910,34:56.5,3
6/5/2021,20PNR2GA,2021 NBA Playoffs - Round 2 - Home Game A,G,0,10965,10965,32:53.4,1
6/5/2021,20PNR2GA,2021 NBA Playoffs - Round 2 - Home Game A,G,10965,17090,6125,16:49.9,2
6/5/2021,20PNR2GA,2021 NBA Playoffs - Round 2 - Home Game A,G,17090,730,-16360,34:56.5,3
6/5/2021,20PNR2GA,2021 NBA Playoffs - Round 2 - Home Game A,H,0,10535,10535,32:53.5,1
6/5/2021,20PNR2GA,2021 NBA Playoffs - Round 2 - Home Game A,H,10535,15770,5235,16:50.0,2
6/5/2021,20PNR2GA,2021 NBA Playoffs - Round 2 - Home Game A,H,15770,675,-15095,34:56.5,3
6/5/2021,20PNR2GA,2021 NBA Playoffs - Round 2 - Home Game A,I,0,9030,9030,32:53.6,1
6/5/2021,20PNR2GA,2021 NBA Playoffs - Round 2 - Home Game A,I,9030,14180,5150,16:50.1,2
6/5/2021,20PNR2GA,2021 NBA Playoffs - Round 2 - Home Game A,I,14180,605,-13575,34:56.5,3
6/5/2021,20PNR2GA,2021 NBA Playoffs - Round 2 - Home Game A,J,0,8385,8385,32:53.7,1
6/5/2021,20PNR2GA,2021 NBA Playoffs - Round 2 - Home Game A,J,8385,13080,4695,16:50.2,2
6/5/2021,20PNR2GA,2021 NBA Playoffs - Round 2 - Home Game A,J,13080,560,-12520,34:56.5,3
6/5/2021,20PNR2GA,2021 NBA Playoffs - Round 2 - Home Game A,K,0,6880,6880,32:53.8,1
6/5/2021,20PNR2GA,2021 NBA Playoffs - Round 2 - Home Game A,K,6880,12160,5280,16:50.3,2
6/5/2021,20PNR2GA,2021 NBA Playoffs - Round 2 - Home Game A,K,12160,520,-11640,34:56.5,3
6/5/2021,20PNR2GA,2021 NBA Playoffs - Round 2 - Home Game A,L,0,6450,6450,32:53.9,1
6/5/2021,20PNR2GA,2021 NBA Playoffs - Round 2 - Home Game A,L,6450,11930,5480,16:50.4,2
6/5/2021,20PNR2GA,2021 NBA Playoffs - Round 2 - Home Game A,L,11930,510,-11420,34:56.5,3
6/5/2021,20PNR2GA,2021 NBA Playoffs - Round 2 - Home Game A,M,0,6020,6020,32:54.0,1
6/5/2021,20PNR2GA,2021 NBA Playoffs - Round 2 - Home Game A,M,6020,10470,4450,16:50.5,2
6/5/2021,20PNR2GA,2021 NBA Playoffs - Round 2 - Home Game A,M,10470,445,-10025,34:56.5,3
6/5/2021,20PNR2GA,2021 NBA Playoffs - Round 2 - Home Game A,N,0,10105,10105,32:54.1,1
6/5/2021,20PNR2GA,2021 NBA Playoffs - Round 2 - Home Game A,N,10105,17290,7185,16:50.6,2
6/5/2021,20PNR2GA,2021 NBA Playoffs - Round 2 - Home Game A,N,17290,740,-16550,34:56.5,3
6/5/2021,20PNR2GA,2021 NBA Playoffs - Round 2 - Home Game A,O,0,9460,9460,32:54.2,1
6/5/2021,20PNR2GA,2021 NBA Playoffs - Round 2 - Home Game A,O,9460,15550,6090,16:50.6,2
6/5/2021,20PNR2GA,2021 NBA Playoffs - Round 2 - Home Game A,O,15550,665,-14885,34:56.5,3
6/5/2021,20PNR2GA,2021 NBA Playoffs - Round 2 - Home Game A,P,0,7740,7740,32:54.3,1
6/5/2021,20PNR2GA,2021 NBA Playoffs - Round 2 - Home Game A,P,7740,13670,5930,16:50.7,2
6/5/2021,20PNR2GA,2021 NBA Playoffs - Round 2 - Home Game A,P,13670,585,-13085,34:56.5,3
6/5/2021,20PNR2GA,2021 NBA Playoffs - Round 2 - Home Game A,Q,0,6880,6880,32:54.4,1
6/5/2021,20PNR2GA,2021 NBA Playoffs - Round 2 - Home Game A,Q,6880,10960,4080,16:50.8,2
6/5/2021,20PNR2GA,2021 NBA Playoffs - Round 2 - Home Game A,Q,10960,470,-10490,34:56.5,3
6/5/2021,20PNR2GA,2021 NBA Playoffs - Round 2 - Home Game A,R,0,5590,5590,32:54.5,1
6/5/2021,20PNR2GA,2021 NBA Playoffs - Round 2 - Home Game A,R,5590,9740,4150,16:50.9,2
6/5/2021,20PNR2GA,2021 NBA Playoffs - Round 2 - Home Game A,R,9740,415,-9325,34:56.5,3
6/5/2021,20PNR2GA,2021 NBA Playoffs - Round 2 - Home Game A,S,0,5590,5590,32:54.6,1
6/5/2021,20PNR2GA,2021 NBA Playoffs - Round 2 - Home Game A,S,5590,9740,4150,16:51.0,2
6/5/2021,20PNR2GA,2021 NBA Playoffs - Round 2 - Home Game A,S,9740,415,-9325,34:56.5,3
6/5/2021,20PNR2GA,2021 NBA Playoffs - Round 2 - Home Game A,T,0,4730,4730,32:54.7,1
6/5/2021,20PNR2GA,2021 NBA Playoffs - Round 2 - Home Game A,T,4730,8030,3300,16:51.1,2
6/5/2021,20PNR2GA,2021 NBA Playoffs - Round 2 - Home Game A,T,8030,340,-7690,34:56.5,3
6/5/2021,20PNR2GA,2021 NBA Playoffs - Round 2 - Home Game A,U,0,3870,3870,32:54.8,1
6/5/2021,20PNR2GA,2021 NBA Playoffs - Round 2 - Home Game A,U,3870,7130,3260,16:51.2,2
6/5/2021,20PNR2GA,2021 NBA Playoffs - Round 2 - Home Game A,U,7130,305,-6825,34:56.5,3
6/5/2021,20PNR2GA,2021 NBA Playoffs - Round 2 - Home Game A,V,0,3440,3440,32:54.9,1
6/5/2021,20PNR2GA,2021 NBA Playoffs - Round 2 - Home Game A,V,3440,6430,2990,16:51.3,2
6/5/2021,20PNR2GA,2021 NBA Playoffs - Round 2 - Home Game A,V,6430,275,-6155,34:56.5,3
6/5/2021,20PNR2GA,2021 NBA Playoffs - Round 2 - Home Game A,W,0,3010,3010,32:55.0,1
6/5/2021,20PNR2GA,2021 NBA Playoffs - Round 2 - Home Game A,W,3010,6030,3020,16:51.4,2
6/5/2021,20PNR2GA,2021 NBA Playoffs - Round 2 - Home Game A,W,6030,255,-5775,34:56.5,3
6/5/2021,20PNR2GA,2021 NBA Playoffs - Round 2 - Home Game A,X,0,2795,2795,32:55.1,1
6/5/2021,20PNR2GA,2021 NBA Playoffs - Round 2 - Home Game A,X,2795,5370,2575,16:51.4,2
6/5/2021,20PNR2GA,2021 NBA Playoffs - Round 2 - Home Game A,X,5370,230,-5140,34:56.5,3
6/5/2021,20PNR2GA,2021 NBA Playoffs - Round 2 - Home Game A,Y,0,2795,2795,32:55.2,1
6/5/2021,20PNR2GA,2021 NBA Playoffs - Round 2 - Home Game A,Y,2795,5220,2425,16:51.5,2
6/5/2021,20PNR2GA,2021 NBA Playoffs - Round 2 - Home Game A,Y,5220,225,-4995,34:56.5,3
6/5/2021,20PNR2GA,2021 NBA Playoffs - Round 2 - Home Game A,Z,0,999999,999999,32:55.3,1
6/5/2021,20PNR2GA,2021 NBA Playoffs - Round 2 - Home Game A,Z,999999,20190,-979809,16:51.6,2
6/5/2021,20PNR2GA,2021 NBA Playoffs - Round 2 - Home Game A,Z,20190,860,-19330,34:56.5,3
6/5/2021,20PNR2VA,2021 NBA Playoffs - Round 2 - Home Game A,1,0,7315,7315,23:02.8,1
6/5/2021,20PNR2VA,2021 NBA Playoffs - Round 2 - Home Game A,1,7315,8000,685,52:05.5,2
6/5/2021,20PNR2VA,2021 NBA Playoffs - Round 2 - Home Game A,1,8000,7500,-500,52:05.4,3
6/5/2021,20PNR2VA,2021 NBA Playoffs - Round 2 - Home Game A,2,0,7315,7315,23:03.0,1
6/5/2021,20PNR2VA,2021 NBA Playoffs - Round 2 - Home Game A,2,7315,8000,685,52:05.5,2
6/5/2021,20PNR2VA,2021 NBA Playoffs - Round 2 - Home Game A,2,8000,7500,-500,52:05.4,3
6/5/2021,20PNR2VA,2021 NBA Playoffs - Round 2 - Home Game A,3,0,7315,7315,23:03.1,1
6/5/2021,20PNR2VA,2021 NBA Playoffs - Round 2 - Home Game A,3,7315,8000,685,52:05.5,2
6/5/2021,20PNR2VA,2021 NBA Playoffs - Round 2 - Home Game A,3,8000,7500,-500,52:05.4,3
6/5/2021,20PNR2VA,2021 NBA Playoffs - Round 2 - Home Game A,4,0,5320,5320,23:03.2,1
6/5/2021,20PNR2VA,2021 NBA Playoffs - Round 2 - Home Game A,4,5320,8000,2680,52:05.5,2
6/5/2021,20PNR2VA,2021 NBA Playoffs - Round 2 - Home Game A,4,8000,7500,-500,52:05.4,3
6/5/2021,20PNR2VA,2021 NBA Playoffs - Round 2 - Home Game A,5,0,2710,2710,23:03.3,1
6/5/2021,20PNR2VA,2021 NBA Playoffs - Round 2 - Home Game A,5,2710,5000,2290,52:05.5,2
6/5/2021,20PNR2VA,2021 NBA Playoffs - Round 2 - Home Game A,5,5000,1630,-3370,52:05.4,3
6/5/2021,20PNR2VA,2021 NBA Playoffs - Round 2 - Home Game A,6,0,2030,2030,23:03.4,1
6/5/2021,20PNR2VA,2021 NBA Playoffs - Round 2 - Home Game A,6,2030,5000,2970,52:05.5,2
6/5/2021,20PNR2VA,2021 NBA Playoffs - Round 2 - Home Game A,6,5000,1370,-3630,52:05.4,3
6/5/2021,20PNR2VA,2021 NBA Playoffs - Round 2 - Home Game A,7,1975,5000,3025,52:05.5,1
6/5/2021,20PNR2VA,2021 NBA Playoffs - Round 2 - Home Game A,7,5000,1070,-3930,52:05.4,2
6/5/2021,20PNR2VA,2021 NBA Playoffs - Round 2 - Home Game A,8,1385,890,-495,52:05.5,1
6/5/2021,20PNR2VA,2021 NBA Playoffs - Round 2 - Home Game A,9,1335,860,-475,52:05.5,1
6/5/2021,20PNR2VA,2021 NBA Playoffs - Round 2 - Home Game A,A,0,1260,1260,23:03.5,1
6/5/2021,20PNR2VA,2021 NBA Playoffs - Round 2 - Home Game A,A,1260,820,-440,52:05.5,2
6/5/2021,20PNR2VA,2021 NBA Playoffs - Round 2 - Home Game A,B,0,1145,1145,23:03.6,1
6/5/2021,20PNR2VA,2021 NBA Playoffs - Round 2 - Home Game A,B,1145,740,-405,52:05.5,2
6/5/2021,20PNR2VA,2021 NBA Playoffs - Round 2 - Home Game A,C,0,1050,1050,23:03.7,1
6/5/2021,20PNR2VA,2021 NBA Playoffs - Round 2 - Home Game A,C,1050,690,-360,52:05.5,2
6/5/2021,20PNR2VA,2021 NBA Playoffs - Round 2 - Home Game A,D,0,1005,1005,23:03.8,1
6/5/2021,20PNR2VA,2021 NBA Playoffs - Round 2 - Home Game A,D,1005,660,-345,52:05.5,2
6/5/2021,20PNR2VA,2021 NBA Playoffs - Round 2 - Home Game A,E,0,845,845,23:03.9,1
6/5/2021,20PNR2VA,2021 NBA Playoffs - Round 2 - Home Game A,E,845,550,-295,52:05.5,2
6/5/2021,20PNR2VA,2021 NBA Playoffs - Round 2 - Home Game A,F,0,800,800,23:04.0,1
6/5/2021,20PNR2VA,2021 NBA Playoffs - Round 2 - Home Game A,F,800,530,-270,52:05.5,2
6/5/2021,20PNR2VA,2021 NBA Playoffs - Round 2 - Home Game A,G,0,730,730,23:04.1,1
6/5/2021,20PNR2VA,2021 NBA Playoffs - Round 2 - Home Game A,G,730,490,-240,52:05.5,2
6/5/2021,20PNR2VA,2021 NBA Playoffs - Round 2 - Home Game A,H,0,675,675,23:04.2,1
6/5/2021,20PNR2VA,2021 NBA Playoffs - Round 2 - Home Game A,H,675,450,-225,52:05.5,2
6/5/2021,20PNR2VA,2021 NBA Playoffs - Round 2 - Home Game A,I,0,605,605,23:04.3,1
6/5/2021,20PNR2VA,2021 NBA Playoffs - Round 2 - Home Game A,I,605,410,-195,52:05.5,2
6/5/2021,20PNR2VA,2021 NBA Playoffs - Round 2 - Home Game A,J,0,560,560,23:04.4,1
6/5/2021,20PNR2VA,2021 NBA Playoffs - Round 2 - Home Game A,J,560,380,-180,52:05.5,2
6/5/2021,20PNR2VA,2021 NBA Playoffs - Round 2 - Home Game A,K,0,520,520,23:04.5,1
6/5/2021,20PNR2VA,2021 NBA Playoffs - Round 2 - Home Game A,K,520,360,-160,52:05.5,2
6/5/2021,20PNR2VA,2021 NBA Playoffs - Round 2 - Home Game A,L,0,510,510,23:04.6,1
6/5/2021,20PNR2VA,2021 NBA Playoffs - Round 2 - Home Game A,L,510,350,-160,52:05.5,2
6/5/2021,20PNR2VA,2021 NBA Playoffs - Round 2 - Home Game A,M,0,445,445,23:04.7,1
6/5/2021,20PNR2VA,2021 NBA Playoffs - Round 2 - Home Game A,M,445,310,-135,52:05.5,2
6/5/2021,20PNR2VA,2021 NBA Playoffs - Round 2 - Home Game A,N,0,740,740,23:04.8,1
6/5/2021,20PNR2VA,2021 NBA Playoffs - Round 2 - Home Game A,N,740,515,-225,52:05.5,2
6/5/2021,20PNR2VA,2021 NBA Playoffs - Round 2 - Home Game A,O,0,665,665,23:04.9,1
6/5/2021,20PNR2VA,2021 NBA Playoffs - Round 2 - Home Game A,O,665,460,-205,52:05.5,2
6/5/2021,20PNR2VA,2021 NBA Playoffs - Round 2 - Home Game A,P,0,585,585,23:05.0,1
6/5/2021,20PNR2VA,2021 NBA Playoffs - Round 2 - Home Game A,P,585,395,-190,52:05.5,2
6/5/2021,20PNR2VA,2021 NBA Playoffs - Round 2 - Home Game A,Q,0,470,470,23:05.1,1
6/5/2021,20PNR2VA,2021 NBA Playoffs - Round 2 - Home Game A,Q,470,325,-145,52:05.5,2
6/5/2021,20PNR2VA,2021 NBA Playoffs - Round 2 - Home Game A,R,0,415,415,23:05.3,1
6/5/2021,20PNR2VA,2021 NBA Playoffs - Round 2 - Home Game A,R,415,285,-130,52:05.5,2
6/5/2021,20PNR2VA,2021 NBA Playoffs - Round 2 - Home Game A,S,0,415,415,23:05.3,1
6/5/2021,20PNR2VA,2021 NBA Playoffs - Round 2 - Home Game A,S,415,285,-130,52:05.5,2
6/5/2021,20PNR2VA,2021 NBA Playoffs - Round 2 - Home Game A,T,0,340,340,23:05.4,1
6/5/2021,20PNR2VA,2021 NBA Playoffs - Round 2 - Home Game A,T,340,240,-100,52:05.5,2
6/5/2021,20PNR2VA,2021 NBA Playoffs - Round 2 - Home Game A,U,0,305,305,23:05.6,1
6/5/2021,20PNR2VA,2021 NBA Playoffs - Round 2 - Home Game A,U,305,220,-85,52:05.5,2
6/5/2021,20PNR2VA,2021 NBA Playoffs - Round 2 - Home Game A,V,0,275,275,23:05.7,1
6/5/2021,20PNR2VA,2021 NBA Playoffs - Round 2 - Home Game A,V,275,195,-80,52:05.5,2
6/5/2021,20PNR2VA,2021 NBA Playoffs - Round 2 - Home Game A,W,0,255,255,23:05.7,1
6/5/2021,20PNR2VA,2021 NBA Playoffs - Round 2 - Home Game A,W,255,175,-80,52:05.5,2
6/5/2021,20PNR2VA,2021 NBA Playoffs - Round 2 - Home Game A,X,0,230,230,23:05.8,1
6/5/2021,20PNR2VA,2021 NBA Playoffs - Round 2 - Home Game A,X,230,165,-65,52:05.5,2
6/5/2021,20PNR2VA,2021 NBA Playoffs - Round 2 - Home Game A,Y,0,225,225,23:05.9,1
6/5/2021,20PNR2VA,2021 NBA Playoffs - Round 2 - Home Game A,Y,225,155,-70,52:05.5,2
6/5/2021,20PNR2VA,2021 NBA Playoffs - Round 2 - Home Game A,Z,0,860,860,23:06.0,1
6/5/2021,20PNR2VA,2021 NBA Playoffs - Round 2 - Home Game A,Z,860,495,-365,52:05.5,2
6/7/2021,20PNR2GB,2021 NBA Playoffs - Round 2 - Home Game B,1,0,236500,236500,32:55.4,1
6/7/2021,20PNR2GB,2021 NBA Playoffs - Round 2 - Home Game B,1,236500,157500,-79000,16:51.7,2
6/7/2021,20PNR2GB,2021 NBA Playoffs - Round 2 - Home Game B,1,157500,7315,-150185,34:56.5,3
6/7/2021,20PNR2GB,2021 NBA Playoffs - Round 2 - Home Game B,2,0,98900,98900,32:55.5,1
6/7/2021,20PNR2GB,2021 NBA Playoffs - Round 2 - Home Game B,2,98900,7315,-91585,34:56.5,2
6/7/2021,20PNR2GB,2021 NBA Playoffs - Round 2 - Home Game B,3,0,85979,85979,32:55.6,1
6/7/2021,20PNR2GB,2021 NBA Playoffs - Round 2 - Home Game B,3,85979,157500,71521,16:51.8,2
6/7/2021,20PNR2GB,2021 NBA Playoffs - Round 2 - Home Game B,3,157500,7315,-150185,34:56.5,3
6/7/2021,20PNR2GB,2021 NBA Playoffs - Round 2 - Home Game B,4,0,47300,47300,32:55.7,1
6/7/2021,20PNR2GB,2021 NBA Playoffs - Round 2 - Home Game B,4,47300,114540,67240,16:51.9,2
6/7/2021,20PNR2GB,2021 NBA Playoffs - Round 2 - Home Game B,4,114540,5320,-109220,34:56.5,3
6/7/2021,20PNR2GB,2021 NBA Playoffs - Round 2 - Home Game B,5,0,43000,43000,32:55.8,1
6/7/2021,20PNR2GB,2021 NBA Playoffs - Round 2 - Home Game B,5,43000,59120,16120,16:52.0,2
6/7/2021,20PNR2GB,2021 NBA Playoffs - Round 2 - Home Game B,5,59120,2920,-56200,34:56.5,3
6/7/2021,20PNR2GB,2021 NBA Playoffs - Round 2 - Home Game B,5,2920,2710,-210,54:56.8,4
6/7/2021,20PNR2GB,2021 NBA Playoffs - Round 2 - Home Game B,5,2920,2710,-210,54:56.8,5
6/7/2021,20PNR2GB,2021 NBA Playoffs - Round 2 - Home Game B,6,0,30100,30100,32:55.9,1
6/7/2021,20PNR2GB,2021 NBA Playoffs - Round 2 - Home Game B,6,30100,41100,11000,16:52.1,2
6/7/2021,20PNR2GB,2021 NBA Playoffs - Round 2 - Home Game B,6,41100,2030,-39070,34:56.5,3
6/7/2021,20PNR2GB,2021 NBA Playoffs - Round 2 - Home Game B,7,23650,38610,14960,16:52.2,1
6/7/2021,20PNR2GB,2021 NBA Playoffs - Round 2 - Home Game B,7,38610,1905,-36705,34:56.5,2
6/7/2021,20PNR2GB,2021 NBA Playoffs - Round 2 - Home Game B,7,1905,1975,70,54:56.8,3
6/7/2021,20PNR2GB,2021 NBA Playoffs - Round 2 - Home Game B,7,1905,1975,70,54:56.8,4
6/7/2021,20PNR2GB,2021 NBA Playoffs - Round 2 - Home Game B,8,18275,32420,14145,16:52.3,1
6/7/2021,20PNR2GB,2021 NBA Playoffs - Round 2 - Home Game B,8,32420,1385,-31035,34:56.5,2
6/7/2021,20PNR2GB,2021 NBA Playoffs - Round 2 - Home Game B,9,17630,31260,13630,16:52.4,1
6/7/2021,20PNR2GB,2021 NBA Playoffs - Round 2 - Home Game B,9,31260,1335,-29925,34:56.5,2
6/7/2021,20PNR2GB,2021 NBA Playoffs - Round 2 - Home Game B,A,0,16770,16770,32:56.0,1
6/7/2021,20PNR2GB,2021 NBA Playoffs - Round 2 - Home Game B,A,16770,29570,12800,16:52.5,2
6/7/2021,20PNR2GB,2021 NBA Playoffs - Round 2 - Home Game B,A,29570,1260,-28310,34:56.5,3
6/7/2021,20PNR2GB,2021 NBA Playoffs - Round 2 - Home Game B,B,0,16125,16125,32:56.1,1
6/7/2021,20PNR2GB,2021 NBA Playoffs - Round 2 - Home Game B,B,16125,26880,10755,16:52.6,2
6/7/2021,20PNR2GB,2021 NBA Playoffs - Round 2 - Home Game B,B,26880,1145,-25735,34:56.5,3
6/7/2021,20PNR2GB,2021 NBA Playoffs - Round 2 - Home Game B,C,0,15050,15050,32:56.2,1
6/7/2021,20PNR2GB,2021 NBA Playoffs - Round 2 - Home Game B,C,15050,24590,9540,16:52.6,2
6/7/2021,20PNR2GB,2021 NBA Playoffs - Round 2 - Home Game B,C,24590,1050,-23540,34:56.5,3
6/7/2021,20PNR2GB,2021 NBA Playoffs - Round 2 - Home Game B,D,0,14190,14190,32:56.3,1
6/7/2021,20PNR2GB,2021 NBA Playoffs - Round 2 - Home Game B,D,14190,23530,9340,16:52.8,2
6/7/2021,20PNR2GB,2021 NBA Playoffs - Round 2 - Home Game B,D,23530,1005,-22525,34:56.5,3
6/7/2021,20PNR2GB,2021 NBA Playoffs - Round 2 - Home Game B,E,0,13330,13330,32:56.4,1
6/7/2021,20PNR2GB,2021 NBA Playoffs - Round 2 - Home Game B,E,13330,19750,6420,16:52.9,2
6/7/2021,20PNR2GB,2021 NBA Playoffs - Round 2 - Home Game B,E,19750,845,-18905,34:56.5,3
6/7/2021,20PNR2GB,2021 NBA Playoffs - Round 2 - Home Game B,F,0,11395,11395,32:56.5,1
6/7/2021,20PNR2GB,2021 NBA Playoffs - Round 2 - Home Game B,F,11395,18710,7315,16:53.0,2
6/7/2021,20PNR2GB,2021 NBA Playoffs - Round 2 - Home Game B,F,18710,800,-17910,34:56.5,3
6/7/2021,20PNR2GB,2021 NBA Playoffs - Round 2 - Home Game B,G,0,10965,10965,32:56.6,1
6/7/2021,20PNR2GB,2021 NBA Playoffs - Round 2 - Home Game B,G,10965,17090,6125,16:53.1,2
6/7/2021,20PNR2GB,2021 NBA Playoffs - Round 2 - Home Game B,G,17090,730,-16360,34:56.5,3
6/7/2021,20PNR2GB,2021 NBA Playoffs - Round 2 - Home Game B,H,0,10535,10535,32:56.7,1
6/7/2021,20PNR2GB,2021 NBA Playoffs - Round 2 - Home Game B,H,10535,15770,5235,16:53.2,2
6/7/2021,20PNR2GB,2021 NBA Playoffs - Round 2 - Home Game B,H,15770,675,-15095,34:56.5,3
6/7/2021,20PNR2GB,2021 NBA Playoffs - Round 2 - Home Game B,I,0,9030,9030,32:56.8,1
6/7/2021,20PNR2GB,2021 NBA Playoffs - Round 2 - Home Game B,I,9030,14180,5150,16:53.3,2
6/7/2021,20PNR2GB,2021 NBA Playoffs - Round 2 - Home Game B,I,14180,605,-13575,34:56.5,3
6/7/2021,20PNR2GB,2021 NBA Playoffs - Round 2 - Home Game B,J,0,8385,8385,32:56.9,1
6/7/2021,20PNR2GB,2021 NBA Playoffs - Round 2 - Home Game B,J,8385,13080,4695,16:53.4,2
6/7/2021,20PNR2GB,2021 NBA Playoffs - Round 2 - Home Game B,J,13080,560,-12520,34:56.5,3
6/7/2021,20PNR2GB,2021 NBA Playoffs - Round 2 - Home Game B,K,0,6880,6880,32:57.0,1
6/7/2021,20PNR2GB,2021 NBA Playoffs - Round 2 - Home Game B,K,6880,12160,5280,16:53.5,2
6/7/2021,20PNR2GB,2021 NBA Playoffs - Round 2 - Home Game B,K,12160,520,-11640,34:56.5,3
6/7/2021,20PNR2GB,2021 NBA Playoffs - Round 2 - Home Game B,L,0,6450,6450,32:57.1,1
6/7/2021,20PNR2GB,2021 NBA Playoffs - Round 2 - Home Game B,L,6450,11930,5480,16:53.5,2
6/7/2021,20PNR2GB,2021 NBA Playoffs - Round 2 - Home Game B,L,11930,510,-11420,34:56.5,3
6/7/2021,20PNR2GB,2021 NBA Playoffs - Round 2 - Home Game B,M,0,6020,6020,32:57.1,1
6/7/2021,20PNR2GB,2021 NBA Playoffs - Round 2 - Home Game B,M,6020,10470,4450,16:53.6,2
6/7/2021,20PNR2GB,2021 NBA Playoffs - Round 2 - Home Game B,M,10470,445,-10025,34:56.5,3
6/7/2021,20PNR2GB,2021 NBA Playoffs - Round 2 - Home Game B,N,0,10105,10105,32:57.2,1
6/7/2021,20PNR2GB,2021 NBA Playoffs - Round 2 - Home Game B,N,10105,17290,7185,16:53.7,2
6/7/2021,20PNR2GB,2021 NBA Playoffs - Round 2 - Home Game B,N,17290,740,-16550,34:56.5,3
6/7/2021,20PNR2GB,2021 NBA Playoffs - Round 2 - Home Game B,O,0,9460,9460,32:57.3,1
6/7/2021,20PNR2GB,2021 NBA Playoffs - Round 2 - Home Game B,O,9460,15550,6090,16:53.8,2
6/7/2021,20PNR2GB,2021 NBA Playoffs - Round 2 - Home Game B,O,15550,665,-14885,34:56.5,3
6/7/2021,20PNR2GB,2021 NBA Playoffs - Round 2 - Home Game B,P,0,7740,7740,32:57.4,1
6/7/2021,20PNR2GB,2021 NBA Playoffs - Round 2 - Home Game B,P,7740,13670,5930,16:53.9,2
6/7/2021,20PNR2GB,2021 NBA Playoffs - Round 2 - Home Game B,P,13670,585,-13085,34:56.5,3
6/7/2021,20PNR2GB,2021 NBA Playoffs - Round 2 - Home Game B,Q,0,6880,6880,32:57.5,1
6/7/2021,20PNR2GB,2021 NBA Playoffs - Round 2 - Home Game B,Q,6880,10960,4080,16:54.0,2
6/7/2021,20PNR2GB,2021 NBA Playoffs - Round 2 - Home Game B,Q,10960,470,-10490,34:56.5,3
6/7/2021,20PNR2GB,2021 NBA Playoffs - Round 2 - Home Game B,R,0,5590,5590,32:57.6,1
6/7/2021,20PNR2GB,2021 NBA Playoffs - Round 2 - Home Game B,R,5590,9740,4150,16:54.1,2
6/7/2021,20PNR2GB,2021 NBA Playoffs - Round 2 - Home Game B,R,9740,415,-9325,34:56.5,3
6/7/2021,20PNR2GB,2021 NBA Playoffs - Round 2 - Home Game B,S,0,5590,5590,32:57.7,1
6/7/2021,20PNR2GB,2021 NBA Playoffs - Round 2 - Home Game B,S,5590,9740,4150,16:54.2,2
6/7/2021,20PNR2GB,2021 NBA Playoffs - Round 2 - Home Game B,S,9740,415,-9325,34:56.5,3
6/7/2021,20PNR2GB,2021 NBA Playoffs - Round 2 - Home Game B,T,0,4730,4730,32:57.8,1
6/7/2021,20PNR2GB,2021 NBA Playoffs - Round 2 - Home Game B,T,4730,8030,3300,16:54.2,2
6/7/2021,20PNR2GB,2021 NBA Playoffs - Round 2 - Home Game B,T,8030,340,-7690,34:56.5,3
6/7/2021,20PNR2GB,2021 NBA Playoffs - Round 2 - Home Game B,U,0,3870,3870,32:57.9,1
6/7/2021,20PNR2GB,2021 NBA Playoffs - Round 2 - Home Game B,U,3870,7130,3260,16:54.3,2
6/7/2021,20PNR2GB,2021 NBA Playoffs - Round 2 - Home Game B,U,7130,305,-6825,34:56.5,3
6/7/2021,20PNR2GB,2021 NBA Playoffs - Round 2 - Home Game B,V,0,3440,3440,32:58.0,1
6/7/2021,20PNR2GB,2021 NBA Playoffs - Round 2 - Home Game B,V,3440,6430,2990,16:54.4,2
6/7/2021,20PNR2GB,2021 NBA Playoffs - Round 2 - Home Game B,V,6430,275,-6155,34:56.5,3
6/7/2021,20PNR2GB,2021 NBA Playoffs - Round 2 - Home Game B,W,0,3010,3010,32:58.1,1
6/7/2021,20PNR2GB,2021 NBA Playoffs - Round 2 - Home Game B,W,3010,6030,3020,16:54.5,2
6/7/2021,20PNR2GB,2021 NBA Playoffs - Round 2 - Home Game B,W,6030,255,-5775,34:56.5,3
6/7/2021,20PNR2GB,2021 NBA Playoffs - Round 2 - Home Game B,X,0,2795,2795,32:58.2,1
6/7/2021,20PNR2GB,2021 NBA Playoffs - Round 2 - Home Game B,X,2795,5370,2575,16:54.6,2
6/7/2021,20PNR2GB,2021 NBA Playoffs - Round 2 - Home Game B,X,5370,230,-5140,34:56.5,3
6/7/2021,20PNR2GB,2021 NBA Playoffs - Round 2 - Home Game B,Y,0,2795,2795,32:58.3,1
6/7/2021,20PNR2GB,2021 NBA Playoffs - Round 2 - Home Game B,Y,2795,5220,2425,16:54.7,2
6/7/2021,20PNR2GB,2021 NBA Playoffs - Round 2 - Home Game B,Y,5220,225,-4995,34:56.5,3
6/7/2021,20PNR2GB,2021 NBA Playoffs - Round 2 - Home Game B,Z,0,999999,999999,32:58.4,1
6/7/2021,20PNR2GB,2021 NBA Playoffs - Round 2 - Home Game B,Z,999999,20190,-979809,16:54.8,2
6/7/2021,20PNR2GB,2021 NBA Playoffs - Round 2 - Home Game B,Z,20190,860,-19330,34:56.5,3
6/7/2021,20PNR2VB,2021 NBA Playoffs - Round 2 - Home Game B,1,0,7315,7315,24:34.2,1
6/7/2021,20PNR2VB,2021 NBA Playoffs - Round 2 - Home Game B,1,7315,8000,685,52:10.8,2
6/7/2021,20PNR2VB,2021 NBA Playoffs - Round 2 - Home Game B,1,8000,7500,-500,52:10.6,3
6/7/2021,20PNR2VB,2021 NBA Playoffs - Round 2 - Home Game B,2,0,7315,7315,24:34.3,1
6/7/2021,20PNR2VB,2021 NBA Playoffs - Round 2 - Home Game B,2,7315,8000,685,52:10.8,2
6/7/2021,20PNR2VB,2021 NBA Playoffs - Round 2 - Home Game B,2,8000,7500,-500,52:10.6,3
6/7/2021,20PNR2VB,2021 NBA Playoffs - Round 2 - Home Game B,3,0,7315,7315,24:34.4,1
6/7/2021,20PNR2VB,2021 NBA Playoffs - Round 2 - Home Game B,3,7315,8000,685,52:10.8,2
6/7/2021,20PNR2VB,2021 NBA Playoffs - Round 2 - Home Game B,3,8000,7500,-500,52:10.6,3
6/7/2021,20PNR2VB,2021 NBA Playoffs - Round 2 - Home Game B,4,0,5320,5320,24:34.6,1
6/7/2021,20PNR2VB,2021 NBA Playoffs - Round 2 - Home Game B,4,5320,8000,2680,52:10.8,2
6/7/2021,20PNR2VB,2021 NBA Playoffs - Round 2 - Home Game B,4,8000,7500,-500,52:10.6,3
6/7/2021,20PNR2VB,2021 NBA Playoffs - Round 2 - Home Game B,5,0,2710,2710,24:34.7,1
6/7/2021,20PNR2VB,2021 NBA Playoffs - Round 2 - Home Game B,5,2710,5000,2290,52:10.8,2
6/7/2021,20PNR2VB,2021 NBA Playoffs - Round 2 - Home Game B,5,5000,1630,-3370,52:10.6,3
6/7/2021,20PNR2VB,2021 NBA Playoffs - Round 2 - Home Game B,6,0,2030,2030,24:34.8,1
6/7/2021,20PNR2VB,2021 NBA Playoffs - Round 2 - Home Game B,6,2030,5000,2970,52:10.8,2
6/7/2021,20PNR2VB,2021 NBA Playoffs - Round 2 - Home Game B,6,5000,1370,-3630,52:10.6,3
6/7/2021,20PNR2VB,2021 NBA Playoffs - Round 2 - Home Game B,7,1975,5000,3025,52:10.8,1
6/7/2021,20PNR2VB,2021 NBA Playoffs - Round 2 - Home Game B,7,5000,1070,-3930,52:10.6,2
6/7/2021,20PNR2VB,2021 NBA Playoffs - Round 2 - Home Game B,8,1385,890,-495,52:10.8,1
6/7/2021,20PNR2VB,2021 NBA Playoffs - Round 2 - Home Game B,9,1335,860,-475,52:10.8,1
6/7/2021,20PNR2VB,2021 NBA Playoffs - Round 2 - Home Game B,A,0,1260,1260,24:34.9,1
6/7/2021,20PNR2VB,2021 NBA Playoffs - Round 2 - Home Game B,A,1260,820,-440,52:10.8,2
6/7/2021,20PNR2VB,2021 NBA Playoffs - Round 2 - Home Game B,B,0,1145,1145,24:35.0,1
6/7/2021,20PNR2VB,2021 NBA Playoffs - Round 2 - Home Game B,B,1145,740,-405,52:10.8,2
6/7/2021,20PNR2VB,2021 NBA Playoffs - Round 2 - Home Game B,C,0,1050,1050,24:35.1,1
6/7/2021,20PNR2VB,2021 NBA Playoffs - Round 2 - Home Game B,C,1050,690,-360,52:10.8,2
6/7/2021,20PNR2VB,2021 NBA Playoffs - Round 2 - Home Game B,D,0,1005,1005,24:35.2,1
6/7/2021,20PNR2VB,2021 NBA Playoffs - Round 2 - Home Game B,D,1005,660,-345,52:10.8,2
6/7/2021,20PNR2VB,2021 NBA Playoffs - Round 2 - Home Game B,E,0,845,845,24:35.3,1
6/7/2021,20PNR2VB,2021 NBA Playoffs - Round 2 - Home Game B,E,845,550,-295,52:10.8,2
6/7/2021,20PNR2VB,2021 NBA Playoffs - Round 2 - Home Game B,F,0,800,800,24:35.4,1
6/7/2021,20PNR2VB,2021 NBA Playoffs - Round 2 - Home Game B,F,800,530,-270,52:10.8,2
6/7/2021,20PNR2VB,2021 NBA Playoffs - Round 2 - Home Game B,G,0,730,730,24:35.5,1
6/7/2021,20PNR2VB,2021 NBA Playoffs - Round 2 - Home Game B,G,730,490,-240,52:10.8,2
6/7/2021,20PNR2VB,2021 NBA Playoffs - Round 2 - Home Game B,H,0,675,675,24:35.6,1
6/7/2021,20PNR2VB,2021 NBA Playoffs - Round 2 - Home Game B,H,675,450,-225,52:10.8,2
6/7/2021,20PNR2VB,2021 NBA Playoffs - Round 2 - Home Game B,I,0,605,605,24:35.7,1
6/7/2021,20PNR2VB,2021 NBA Playoffs - Round 2 - Home Game B,I,605,410,-195,52:10.8,2
6/7/2021,20PNR2VB,2021 NBA Playoffs - Round 2 - Home Game B,J,0,560,560,24:35.8,1
6/7/2021,20PNR2VB,2021 NBA Playoffs - Round 2 - Home Game B,J,560,380,-180,52:10.8,2
6/7/2021,20PNR2VB,2021 NBA Playoffs - Round 2 - Home Game B,K,0,520,520,24:35.9,1
6/7/2021,20PNR2VB,2021 NBA Playoffs - Round 2 - Home Game B,K,520,360,-160,52:10.8,2
6/7/2021,20PNR2VB,2021 NBA Playoffs - Round 2 - Home Game B,L,0,510,510,24:36.0,1
6/7/2021,20PNR2VB,2021 NBA Playoffs - Round 2 - Home Game B,L,510,350,-160,52:10.8,2
6/7/2021,20PNR2VB,2021 NBA Playoffs - Round 2 - Home Game B,M,0,445,445,24:36.1,1
6/7/2021,20PNR2VB,2021 NBA Playoffs - Round 2 - Home Game B,M,445,310,-135,52:10.8,2
6/7/2021,20PNR2VB,2021 NBA Playoffs - Round 2 - Home Game B,N,0,740,740,24:36.2,1
6/7/2021,20PNR2VB,2021 NBA Playoffs - Round 2 - Home Game B,N,740,515,-225,52:10.8,2
6/7/2021,20PNR2VB,2021 NBA Playoffs - Round 2 - Home Game B,O,0,665,665,24:36.3,1
6/7/2021,20PNR2VB,2021 NBA Playoffs - Round 2 - Home Game B,O,665,460,-205,52:10.8,2
6/7/2021,20PNR2VB,2021 NBA Playoffs - Round 2 - Home Game B,P,0,585,585,24:36.4,1
6/7/2021,20PNR2VB,2021 NBA Playoffs - Round 2 - Home Game B,P,585,395,-190,52:10.8,2
6/7/2021,20PNR2VB,2021 NBA Playoffs - Round 2 - Home Game B,Q,0,470,470,24:36.5,1
6/7/2021,20PNR2VB,2021 NBA Playoffs - Round 2 - Home Game B,Q,470,325,-145,52:10.8,2
6/7/2021,20PNR2VB,2021 NBA Playoffs - Round 2 - Home Game B,R,0,415,415,24:36.7,1
6/7/2021,20PNR2VB,2021 NBA Playoffs - Round 2 - Home Game B,R,415,285,-130,52:10.8,2
6/7/2021,20PNR2VB,2021 NBA Playoffs - Round 2 - Home Game B,S,0,415,415,24:36.7,1
6/7/2021,20PNR2VB,2021 NBA Playoffs - Round 2 - Home Game B,S,415,285,-130,52:10.8,2
6/7/2021,20PNR2VB,2021 NBA Playoffs - Round 2 - Home Game B,T,0,340,340,24:36.8,1
6/7/2021,20PNR2VB,2021 NBA Playoffs - Round 2 - Home Game B,T,340,240,-100,52:10.8,2
6/7/2021,20PNR2VB,2021 NBA Playoffs - Round 2 - Home Game B,U,0,305,305,24:36.9,1
6/7/2021,20PNR2VB,2021 NBA Playoffs - Round 2 - Home Game B,U,305,220,-85,52:10.8,2
6/7/2021,20PNR2VB,2021 NBA Playoffs - Round 2 - Home Game B,V,0,275,275,24:37.0,1
6/7/2021,20PNR2VB,2021 NBA Playoffs - Round 2 - Home Game B,V,275,195,-80,52:10.8,2
6/7/2021,20PNR2VB,2021 NBA Playoffs - Round 2 - Home Game B,W,0,255,255,24:37.2,1
6/7/2021,20PNR2VB,2021 NBA Playoffs - Round 2 - Home Game B,W,255,175,-80,52:10.8,2
6/7/2021,20PNR2VB,2021 NBA Playoffs - Round 2 - Home Game B,X,0,230,230,24:37.2,1
6/7/2021,20PNR2VB,2021 NBA Playoffs - Round 2 - Home Game B,X,230,165,-65,52:10.8,2
6/7/2021,20PNR2VB,2021 NBA Playoffs - Round 2 - Home Game B,Y,0,225,225,24:37.3,1
6/7/2021,20PNR2VB,2021 NBA Playoffs - Round 2 - Home Game B,Y,225,155,-70,52:10.8,2
6/7/2021,20PNR2VB,2021 NBA Playoffs - Round 2 - Home Game B,Z,0,860,860,24:37.4,1
6/7/2021,20PNR2VB,2021 NBA Playoffs - Round 2 - Home Game B,Z,860,495,-365,52:10.8,2
6/14/2021,20PNR2GC,2021 NBA Playoffs - Round 2 - Home Game C,1,0,236500,236500,32:58.5,1
6/14/2021,20PNR2GC,2021 NBA Playoffs - Round 2 - Home Game C,1,236500,157500,-79000,16:54.9,2
6/14/2021,20PNR2GC,2021 NBA Playoffs - Round 2 - Home Game C,1,157500,8800,-148700,34:56.5,3
6/14/2021,20PNR2GC,2021 NBA Playoffs - Round 2 - Home Game C,2,0,98900,98900,32:58.6,1
6/14/2021,20PNR2GC,2021 NBA Playoffs - Round 2 - Home Game C,2,98900,8800,-90100,34:56.5,2
6/14/2021,20PNR2GC,2021 NBA Playoffs - Round 2 - Home Game C,3,0,85979,85979,32:58.7,1
6/14/2021,20PNR2GC,2021 NBA Playoffs - Round 2 - Home Game C,3,85979,157500,71521,16:55.0,2
6/14/2021,20PNR2GC,2021 NBA Playoffs - Round 2 - Home Game C,3,157500,8800,-148700,34:56.5,3
6/14/2021,20PNR2GC,2021 NBA Playoffs - Round 2 - Home Game C,4,0,47300,47300,32:58.8,1
6/14/2021,20PNR2GC,2021 NBA Playoffs - Round 2 - Home Game C,4,47300,114540,67240,16:55.1,2
6/14/2021,20PNR2GC,2021 NBA Playoffs - Round 2 - Home Game C,4,114540,6400,-108140,34:56.5,3
6/14/2021,20PNR2GC,2021 NBA Playoffs - Round 2 - Home Game C,5,0,43000,43000,32:58.9,1
6/14/2021,20PNR2GC,2021 NBA Playoffs - Round 2 - Home Game C,5,43000,59120,16120,16:55.1,2
6/14/2021,20PNR2GC,2021 NBA Playoffs - Round 2 - Home Game C,5,59120,3490,-55630,34:56.5,3
6/14/2021,20PNR2GC,2021 NBA Playoffs - Round 2 - Home Game C,5,3490,3240,-250,54:56.8,4
6/14/2021,20PNR2GC,2021 NBA Playoffs - Round 2 - Home Game C,5,3490,3240,-250,54:56.8,5
6/14/2021,20PNR2GC,2021 NBA Playoffs - Round 2 - Home Game C,6,0,30100,30100,32:59.0,1
6/14/2021,20PNR2GC,2021 NBA Playoffs - Round 2 - Home Game C,6,30100,41100,11000,16:55.2,2
6/14/2021,20PNR2GC,2021 NBA Playoffs - Round 2 - Home Game C,6,41100,2425,-38675,34:56.5,3
6/14/2021,20PNR2GC,2021 NBA Playoffs - Round 2 - Home Game C,7,23650,38610,14960,16:55.3,1
6/14/2021,20PNR2GC,2021 NBA Playoffs - Round 2 - Home Game C,7,38610,2280,-36330,34:56.5,2
6/14/2021,20PNR2GC,2021 NBA Playoffs - Round 2 - Home Game C,7,2280,2365,85,54:56.8,3
6/14/2021,20PNR2GC,2021 NBA Playoffs - Round 2 - Home Game C,7,2280,2365,85,54:56.8,4
6/14/2021,20PNR2GC,2021 NBA Playoffs - Round 2 - Home Game C,8,18275,32420,14145,16:55.4,1
6/14/2021,20PNR2GC,2021 NBA Playoffs - Round 2 - Home Game C,8,32420,1655,-30765,34:56.5,2
6/14/2021,20PNR2GC,2021 NBA Playoffs - Round 2 - Home Game C,9,17630,31260,13630,16:55.5,1
6/14/2021,20PNR2GC,2021 NBA Playoffs - Round 2 - Home Game C,9,31260,1595,-29665,34:56.5,2
6/14/2021,20PNR2GC,2021 NBA Playoffs - Round 2 - Home Game C,A,0,16770,16770,32:59.1,1
6/14/2021,20PNR2GC,2021 NBA Playoffs - Round 2 - Home Game C,A,16770,29570,12800,16:55.6,2
6/14/2021,20PNR2GC,2021 NBA Playoffs - Round 2 - Home Game C,A,29570,1510,-28060,34:56.5,3
6/14/2021,20PNR2GC,2021 NBA Playoffs - Round 2 - Home Game C,B,0,16125,16125,32:59.2,1
6/14/2021,20PNR2GC,2021 NBA Playoffs - Round 2 - Home Game C,B,16125,26880,10755,16:55.7,2
6/14/2021,20PNR2GC,2021 NBA Playoffs - Round 2 - Home Game C,B,26880,1370,-25510,34:56.5,3
6/14/2021,20PNR2GC,2021 NBA Playoffs - Round 2 - Home Game C,C,0,15050,15050,32:59.3,1
6/14/2021,20PNR2GC,2021 NBA Playoffs - Round 2 - Home Game C,C,15050,24590,9540,16:55.8,2
6/14/2021,20PNR2GC,2021 NBA Playoffs - Round 2 - Home Game C,C,24590,1255,-23335,34:56.5,3
6/14/2021,20PNR2GC,2021 NBA Playoffs - Round 2 - Home Game C,D,0,14190,14190,32:59.4,1
6/14/2021,20PNR2GC,2021 NBA Playoffs - Round 2 - Home Game C,D,14190,23530,9340,16:55.9,2
6/14/2021,20PNR2GC,2021 NBA Playoffs - Round 2 - Home Game C,D,23530,1200,-22330,34:56.5,3
6/14/2021,20PNR2GC,2021 NBA Playoffs - Round 2 - Home Game C,E,0,13330,13330,32:59.5,1
6/14/2021,20PNR2GC,2021 NBA Playoffs - Round 2 - Home Game C,E,13330,19750,6420,16:56.0,2
6/14/2021,20PNR2GC,2021 NBA Playoffs - Round 2 - Home Game C,E,19750,1005,-18745,34:56.5,3
6/14/2021,20PNR2GC,2021 NBA Playoffs - Round 2 - Home Game C,F,0,11395,11395,32:59.6,1
6/14/2021,20PNR2GC,2021 NBA Playoffs - Round 2 - Home Game C,F,11395,18710,7315,16:56.1,2
6/14/2021,20PNR2GC,2021 NBA Playoffs - Round 2 - Home Game C,F,18710,955,-17755,34:56.5,3
6/14/2021,20PNR2GC,2021 NBA Playoffs - Round 2 - Home Game C,G,0,10965,10965,32:59.7,1
6/14/2021,20PNR2GC,2021 NBA Playoffs - Round 2 - Home Game C,G,10965,17090,6125,16:56.2,2
6/14/2021,20PNR2GC,2021 NBA Playoffs - Round 2 - Home Game C,G,17090,870,-16220,34:56.5,3
6/14/2021,20PNR2GC,2021 NBA Playoffs - Round 2 - Home Game C,H,0,10535,10535,32:59.8,1
6/14/2021,20PNR2GC,2021 NBA Playoffs - Round 2 - Home Game C,H,10535,15770,5235,16:56.2,2
6/14/2021,20PNR2GC,2021 NBA Playoffs - Round 2 - Home Game C,H,15770,805,-14965,34:56.5,3
6/14/2021,20PNR2GC,2021 NBA Playoffs - Round 2 - Home Game C,I,0,9030,9030,32:59.9,1
6/14/2021,20PNR2GC,2021 NBA Playoffs - Round 2 - Home Game C,I,9030,14180,5150,16:56.3,2
6/14/2021,20PNR2GC,2021 NBA Playoffs - Round 2 - Home Game C,I,14180,725,-13455,34:56.5,3
6/14/2021,20PNR2GC,2021 NBA Playoffs - Round 2 - Home Game C,J,0,8385,8385,32:59.9,1
6/14/2021,20PNR2GC,2021 NBA Playoffs - Round 2 - Home Game C,J,8385,13080,4695,16:56.4,2
6/14/2021,20PNR2GC,2021 NBA Playoffs - Round 2 - Home Game C,J,13080,665,-12415,34:56.5,3
6/14/2021,20PNR2GC,2021 NBA Playoffs - Round 2 - Home Game C,K,0,6880,6880,33:00.1,1
6/14/2021,20PNR2GC,2021 NBA Playoffs - Round 2 - Home Game C,K,6880,12160,5280,16:56.5,2
6/14/2021,20PNR2GC,2021 NBA Playoffs - Round 2 - Home Game C,K,12160,620,-11540,34:56.5,3
6/14/2021,20PNR2GC,2021 NBA Playoffs - Round 2 - Home Game C,L,0,6450,6450,33:00.2,1
6/14/2021,20PNR2GC,2021 NBA Playoffs - Round 2 - Home Game C,L,6450,11930,5480,16:56.6,2
6/14/2021,20PNR2GC,2021 NBA Playoffs - Round 2 - Home Game C,L,11930,610,-11320,34:56.5,3
6/14/2021,20PNR2GC,2021 NBA Playoffs - Round 2 - Home Game C,M,0,6020,6020,33:00.3,1
6/14/2021,20PNR2GC,2021 NBA Playoffs - Round 2 - Home Game C,M,6020,10470,4450,16:56.7,2
6/14/2021,20PNR2GC,2021 NBA Playoffs - Round 2 - Home Game C,M,10470,535,-9935,34:56.5,3
6/14/2021,20PNR2GC,2021 NBA Playoffs - Round 2 - Home Game C,N,0,10105,10105,33:00.4,1
6/14/2021,20PNR2GC,2021 NBA Playoffs - Round 2 - Home Game C,N,10105,17290,7185,16:56.8,2
6/14/2021,20PNR2GC,2021 NBA Playoffs - Round 2 - Home Game C,N,17290,880,-16410,34:56.5,3
6/14/2021,20PNR2GC,2021 NBA Playoffs - Round 2 - Home Game C,O,0,9460,9460,33:00.6,1
6/14/2021,20PNR2GC,2021 NBA Playoffs - Round 2 - Home Game C,O,9460,15550,6090,16:56.9,2
6/14/2021,20PNR2GC,2021 NBA Playoffs - Round 2 - Home Game C,O,15550,795,-14755,34:56.5,3
6/14/2021,20PNR2GC,2021 NBA Playoffs - Round 2 - Home Game C,P,0,7740,7740,33:00.7,1
6/14/2021,20PNR2GC,2021 NBA Playoffs - Round 2 - Home Game C,P,7740,13670,5930,16:57.0,2
6/14/2021,20PNR2GC,2021 NBA Playoffs - Round 2 - Home Game C,P,13670,695,-12975,34:56.5,3
6/14/2021,20PNR2GC,2021 NBA Playoffs - Round 2 - Home Game C,Q,0,6880,6880,33:00.8,1
6/14/2021,20PNR2GC,2021 NBA Playoffs - Round 2 - Home Game C,Q,6880,10960,4080,16:57.0,2
6/14/2021,20PNR2GC,2021 NBA Playoffs - Round 2 - Home Game C,Q,10960,560,-10400,34:56.5,3
6/14/2021,20PNR2GC,2021 NBA Playoffs - Round 2 - Home Game C,R,0,5590,5590,33:00.9,1
6/14/2021,20PNR2GC,2021 NBA Playoffs - Round 2 - Home Game C,R,5590,9740,4150,16:57.1,2
6/14/2021,20PNR2GC,2021 NBA Playoffs - Round 2 - Home Game C,R,9740,495,-9245,34:56.5,3
6/14/2021,20PNR2GC,2021 NBA Playoffs - Round 2 - Home Game C,S,0,5590,5590,33:01.0,1
6/14/2021,20PNR2GC,2021 NBA Playoffs - Round 2 - Home Game C,S,5590,9740,4150,16:57.2,2
6/14/2021,20PNR2GC,2021 NBA Playoffs - Round 2 - Home Game C,S,9740,495,-9245,34:56.5,3
6/14/2021,20PNR2GC,2021 NBA Playoffs - Round 2 - Home Game C,T,0,4730,4730,33:01.1,1
6/14/2021,20PNR2GC,2021 NBA Playoffs - Round 2 - Home Game C,T,4730,8030,3300,16:57.3,2
6/14/2021,20PNR2GC,2021 NBA Playoffs - Round 2 - Home Game C,T,8030,410,-7620,34:56.5,3
6/14/2021,20PNR2GC,2021 NBA Playoffs - Round 2 - Home Game C,U,0,3870,3870,33:01.2,1
6/14/2021,20PNR2GC,2021 NBA Playoffs - Round 2 - Home Game C,U,3870,7130,3260,16:57.4,2
6/14/2021,20PNR2GC,2021 NBA Playoffs - Round 2 - Home Game C,U,7130,365,-6765,34:56.5,3
6/14/2021,20PNR2GC,2021 NBA Playoffs - Round 2 - Home Game C,V,0,3440,3440,33:01.3,1
6/14/2021,20PNR2GC,2021 NBA Playoffs - Round 2 - Home Game C,V,3440,6430,2990,16:57.5,2
6/14/2021,20PNR2GC,2021 NBA Playoffs - Round 2 - Home Game C,V,6430,330,-6100,34:56.5,3
6/14/2021,20PNR2GC,2021 NBA Playoffs - Round 2 - Home Game C,W,0,3010,3010,33:01.4,1
6/14/2021,20PNR2GC,2021 NBA Playoffs - Round 2 - Home Game C,W,3010,6030,3020,16:57.6,2
6/14/2021,20PNR2GC,2021 NBA Playoffs - Round 2 - Home Game C,W,6030,305,-5725,34:56.5,3
6/14/2021,20PNR2GC,2021 NBA Playoffs - Round 2 - Home Game C,X,0,2795,2795,33:01.4,1
6/14/2021,20PNR2GC,2021 NBA Playoffs - Round 2 - Home Game C,X,2795,5370,2575,16:57.7,2
6/14/2021,20PNR2GC,2021 NBA Playoffs - Round 2 - Home Game C,X,5370,275,-5095,34:56.5,3
6/14/2021,20PNR2GC,2021 NBA Playoffs - Round 2 - Home Game C,Y,0,2795,2795,33:01.5,1
6/14/2021,20PNR2GC,2021 NBA Playoffs - Round 2 - Home Game C,Y,2795,5220,2425,16:57.8,2
6/14/2021,20PNR2GC,2021 NBA Playoffs - Round 2 - Home Game C,Y,5220,265,-4955,34:56.5,3
6/14/2021,20PNR2GC,2021 NBA Playoffs - Round 2 - Home Game C,Z,0,999999,999999,33:01.6,1
6/14/2021,20PNR2GC,2021 NBA Playoffs - Round 2 - Home Game C,Z,999999,20190,-979809,16:57.9,2
6/14/2021,20PNR2GC,2021 NBA Playoffs - Round 2 - Home Game C,Z,20190,1030,-19160,34:56.5,3
6/14/2021,20PNR2VC,2021 NBA Playoffs - Round 2 - Home Game C,1,0,8800,8800,25:51.4,1
6/14/2021,20PNR2VC,2021 NBA Playoffs - Round 2 - Home Game C,1,8800,8000,-800,52:16.0,2
6/14/2021,20PNR2VC,2021 NBA Playoffs - Round 2 - Home Game C,1,8000,9000,1000,52:15.7,3
6/14/2021,20PNR2VC,2021 NBA Playoffs - Round 2 - Home Game C,2,0,8800,8800,25:51.6,1
6/14/2021,20PNR2VC,2021 NBA Playoffs - Round 2 - Home Game C,2,8800,8000,-800,52:16.0,2
6/14/2021,20PNR2VC,2021 NBA Playoffs - Round 2 - Home Game C,2,8000,9000,1000,52:15.7,3
6/14/2021,20PNR2VC,2021 NBA Playoffs - Round 2 - Home Game C,3,0,8800,8800,25:51.7,1
6/14/2021,20PNR2VC,2021 NBA Playoffs - Round 2 - Home Game C,3,8800,8000,-800,52:16.0,2
6/14/2021,20PNR2VC,2021 NBA Playoffs - Round 2 - Home Game C,3,8000,9000,1000,52:15.7,3
6/14/2021,20PNR2VC,2021 NBA Playoffs - Round 2 - Home Game C,4,0,6400,6400,25:51.9,1
6/14/2021,20PNR2VC,2021 NBA Playoffs - Round 2 - Home Game C,4,6400,8000,1600,52:16.0,2
6/14/2021,20PNR2VC,2021 NBA Playoffs - Round 2 - Home Game C,4,8000,9000,1000,52:15.7,3
6/14/2021,20PNR2VC,2021 NBA Playoffs - Round 2 - Home Game C,5,0,3240,3240,25:52.0,1
6/14/2021,20PNR2VC,2021 NBA Playoffs - Round 2 - Home Game C,5,3240,5000,1760,52:16.0,2
6/14/2021,20PNR2VC,2021 NBA Playoffs - Round 2 - Home Game C,5,5000,1950,-3050,52:15.7,3
6/14/2021,20PNR2VC,2021 NBA Playoffs - Round 2 - Home Game C,6,0,2425,2425,25:52.1,1
6/14/2021,20PNR2VC,2021 NBA Playoffs - Round 2 - Home Game C,6,2425,5000,2575,52:16.0,2
6/14/2021,20PNR2VC,2021 NBA Playoffs - Round 2 - Home Game C,6,5000,1640,-3360,52:15.7,3
6/14/2021,20PNR2VC,2021 NBA Playoffs - Round 2 - Home Game C,7,2365,5000,2635,52:16.0,1
6/14/2021,20PNR2VC,2021 NBA Playoffs - Round 2 - Home Game C,7,5000,1280,-3720,52:15.7,2
6/14/2021,20PNR2VC,2021 NBA Playoffs - Round 2 - Home Game C,8,1655,1070,-585,52:16.0,1
6/14/2021,20PNR2VC,2021 NBA Playoffs - Round 2 - Home Game C,9,1595,1030,-565,52:16.0,1
6/14/2021,20PNR2VC,2021 NBA Playoffs - Round 2 - Home Game C,A,0,1510,1510,25:52.2,1
6/14/2021,20PNR2VC,2021 NBA Playoffs - Round 2 - Home Game C,A,1510,980,-530,52:16.0,2
6/14/2021,20PNR2VC,2021 NBA Playoffs - Round 2 - Home Game C,B,0,1370,1370,25:52.3,1
6/14/2021,20PNR2VC,2021 NBA Playoffs - Round 2 - Home Game C,B,1370,890,-480,52:16.0,2
6/14/2021,20PNR2VC,2021 NBA Playoffs - Round 2 - Home Game C,C,0,1255,1255,25:52.4,1
6/14/2021,20PNR2VC,2021 NBA Playoffs - Round 2 - Home Game C,C,1255,825,-430,52:16.0,2
6/14/2021,20PNR2VC,2021 NBA Playoffs - Round 2 - Home Game C,D,0,1200,1200,25:52.6,1
6/14/2021,20PNR2VC,2021 NBA Playoffs - Round 2 - Home Game C,D,1200,790,-410,52:16.0,2
6/14/2021,20PNR2VC,2021 NBA Playoffs - Round 2 - Home Game C,E,0,1005,1005,25:52.7,1
6/14/2021,20PNR2VC,2021 NBA Playoffs - Round 2 - Home Game C,E,1005,660,-345,52:16.0,2
6/14/2021,20PNR2VC,2021 NBA Playoffs - Round 2 - Home Game C,F,0,955,955,25:52.8,1
6/14/2021,20PNR2VC,2021 NBA Playoffs - Round 2 - Home Game C,F,955,635,-320,52:16.0,2
6/14/2021,20PNR2VC,2021 NBA Playoffs - Round 2 - Home Game C,G,0,870,870,25:52.9,1
6/14/2021,20PNR2VC,2021 NBA Playoffs - Round 2 - Home Game C,G,870,585,-285,52:16.0,2
6/14/2021,20PNR2VC,2021 NBA Playoffs - Round 2 - Home Game C,H,0,805,805,25:53.0,1
6/14/2021,20PNR2VC,2021 NBA Playoffs - Round 2 - Home Game C,H,805,535,-270,52:16.0,2
6/14/2021,20PNR2VC,2021 NBA Playoffs - Round 2 - Home Game C,I,0,725,725,25:53.1,1
6/14/2021,20PNR2VC,2021 NBA Playoffs - Round 2 - Home Game C,I,725,485,-240,52:16.0,2
6/14/2021,20PNR2VC,2021 NBA Playoffs - Round 2 - Home Game C,J,0,665,665,25:53.2,1
6/14/2021,20PNR2VC,2021 NBA Playoffs - Round 2 - Home Game C,J,665,460,-205,52:16.0,2
6/14/2021,20PNR2VC,2021 NBA Playoffs - Round 2 - Home Game C,K,0,620,620,25:53.3,1
6/14/2021,20PNR2VC,2021 NBA Playoffs - Round 2 - Home Game C,K,620,430,-190,52:16.0,2
6/14/2021,20PNR2VC,2021 NBA Playoffs - Round 2 - Home Game C,L,0,610,610,25:53.4,1
6/14/2021,20PNR2VC,2021 NBA Playoffs - Round 2 - Home Game C,L,610,420,-190,52:16.0,2
6/14/2021,20PNR2VC,2021 NBA Playoffs - Round 2 - Home Game C,M,0,535,535,25:53.5,1
6/14/2021,20PNR2VC,2021 NBA Playoffs - Round 2 - Home Game C,M,535,370,-165,52:16.0,2
6/14/2021,20PNR2VC,2021 NBA Playoffs - Round 2 - Home Game C,N,0,880,880,25:53.6,1
6/14/2021,20PNR2VC,2021 NBA Playoffs - Round 2 - Home Game C,N,880,610,-270,52:16.0,2
6/14/2021,20PNR2VC,2021 NBA Playoffs - Round 2 - Home Game C,O,0,795,795,25:53.7,1
6/14/2021,20PNR2VC,2021 NBA Playoffs - Round 2 - Home Game C,O,795,545,-250,52:16.0,2
6/14/2021,20PNR2VC,2021 NBA Playoffs - Round 2 - Home Game C,P,0,695,695,25:53.8,1
6/14/2021,20PNR2VC,2021 NBA Playoffs - Round 2 - Home Game C,P,695,475,-220,52:16.0,2
6/14/2021,20PNR2VC,2021 NBA Playoffs - Round 2 - Home Game C,Q,0,560,560,25:53.9,1
6/14/2021,20PNR2VC,2021 NBA Playoffs - Round 2 - Home Game C,Q,560,390,-170,52:16.0,2
6/14/2021,20PNR2VC,2021 NBA Playoffs - Round 2 - Home Game C,R,0,495,495,25:54.1,1
6/14/2021,20PNR2VC,2021 NBA Playoffs - Round 2 - Home Game C,R,495,340,-155,52:16.0,2
6/14/2021,20PNR2VC,2021 NBA Playoffs - Round 2 - Home Game C,S,0,495,495,25:54.4,1
6/14/2021,20PNR2VC,2021 NBA Playoffs - Round 2 - Home Game C,S,495,340,-155,52:16.0,2
6/14/2021,20PNR2VC,2021 NBA Playoffs - Round 2 - Home Game C,T,0,410,410,25:54.6,1
6/14/2021,20PNR2VC,2021 NBA Playoffs - Round 2 - Home Game C,T,410,290,-120,52:16.0,2
6/14/2021,20PNR2VC,2021 NBA Playoffs - Round 2 - Home Game C,U,0,365,365,25:54.7,1
6/14/2021,20PNR2VC,2021 NBA Playoffs - Round 2 - Home Game C,U,365,265,-100,52:16.0,2
6/14/2021,20PNR2VC,2021 NBA Playoffs - Round 2 - Home Game C,V,0,330,330,25:54.9,1
6/14/2021,20PNR2VC,2021 NBA Playoffs - Round 2 - Home Game C,V,330,230,-100,52:16.0,2
6/14/2021,20PNR2VC,2021 NBA Playoffs - Round 2 - Home Game C,W,0,305,305,25:55.0,1
6/14/2021,20PNR2VC,2021 NBA Playoffs - Round 2 - Home Game C,W,305,215,-90,52:16.0,2
6/14/2021,20PNR2VC,2021 NBA Playoffs - Round 2 - Home Game C,X,0,275,275,25:55.1,1
6/14/2021,20PNR2VC,2021 NBA Playoffs - Round 2 - Home Game C,X,275,195,-80,52:16.0,2
6/14/2021,20PNR2VC,2021 NBA Playoffs - Round 2 - Home Game C,Y,0,265,265,25:55.2,1
6/14/2021,20PNR2VC,2021 NBA Playoffs - Round 2 - Home Game C,Y,265,185,-80,52:16.0,2
6/14/2021,20PNR2VC,2021 NBA Playoffs - Round 2 - Home Game C,Z,0,1030,1030,25:55.3,1
6/14/2021,20PNR2VC,2021 NBA Playoffs - Round 2 - Home Game C,Z,1030,590,-440,52:16.0,2
6/17/2021,20PNR2GD,2021 NBA Playoffs - Round 2 - Home Game D,1,0,236500,236500,33:01.7,1
6/17/2021,20PNR2GD,2021 NBA Playoffs - Round 2 - Home Game D,1,236500,157500,-79000,16:58.0,2
6/17/2021,20PNR2GD,2021 NBA Playoffs - Round 2 - Home Game D,1,157500,8800,-148700,34:56.5,3
6/17/2021,20PNR2GD,2021 NBA Playoffs - Round 2 - Home Game D,2,0,98900,98900,33:01.8,1
6/17/2021,20PNR2GD,2021 NBA Playoffs - Round 2 - Home Game D,2,98900,8800,-90100,34:56.5,2
6/17/2021,20PNR2GD,2021 NBA Playoffs - Round 2 - Home Game D,3,0,85979,85979,33:01.9,1
6/17/2021,20PNR2GD,2021 NBA Playoffs - Round 2 - Home Game D,3,85979,157500,71521,16:58.1,2
6/17/2021,20PNR2GD,2021 NBA Playoffs - Round 2 - Home Game D,3,157500,8800,-148700,34:56.5,3
6/17/2021,20PNR2GD,2021 NBA Playoffs - Round 2 - Home Game D,4,0,47300,47300,33:02.0,1
6/17/2021,20PNR2GD,2021 NBA Playoffs - Round 2 - Home Game D,4,47300,114540,67240,16:58.2,2
6/17/2021,20PNR2GD,2021 NBA Playoffs - Round 2 - Home Game D,4,114540,6400,-108140,34:56.5,3
6/17/2021,20PNR2GD,2021 NBA Playoffs - Round 2 - Home Game D,5,0,43000,43000,33:02.1,1
6/17/2021,20PNR2GD,2021 NBA Playoffs - Round 2 - Home Game D,5,43000,59120,16120,16:58.3,2
6/17/2021,20PNR2GD,2021 NBA Playoffs - Round 2 - Home Game D,5,59120,3490,-55630,34:56.5,3
6/17/2021,20PNR2GD,2021 NBA Playoffs - Round 2 - Home Game D,5,3490,3240,-250,54:56.8,4
6/17/2021,20PNR2GD,2021 NBA Playoffs - Round 2 - Home Game D,5,3490,3240,-250,54:56.8,5
6/17/2021,20PNR2GD,2021 NBA Playoffs - Round 2 - Home Game D,6,0,30100,30100,33:02.2,1
6/17/2021,20PNR2GD,2021 NBA Playoffs - Round 2 - Home Game D,6,30100,41100,11000,16:58.4,2
6/17/2021,20PNR2GD,2021 NBA Playoffs - Round 2 - Home Game D,6,41100,2425,-38675,34:56.5,3
6/17/2021,20PNR2GD,2021 NBA Playoffs - Round 2 - Home Game D,7,23650,38610,14960,16:58.5,1
6/17/2021,20PNR2GD,2021 NBA Playoffs - Round 2 - Home Game D,7,38610,2280,-36330,34:56.5,2
6/17/2021,20PNR2GD,2021 NBA Playoffs - Round 2 - Home Game D,7,2280,2365,85,54:56.8,3
6/17/2021,20PNR2GD,2021 NBA Playoffs - Round 2 - Home Game D,7,2280,2365,85,54:56.8,4
6/17/2021,20PNR2GD,2021 NBA Playoffs - Round 2 - Home Game D,8,18275,32420,14145,16:58.6,1
6/17/2021,20PNR2GD,2021 NBA Playoffs - Round 2 - Home Game D,8,32420,1655,-30765,34:56.5,2
6/17/2021,20PNR2GD,2021 NBA Playoffs - Round 2 - Home Game D,9,17630,31260,13630,16:58.7,1
6/17/2021,20PNR2GD,2021 NBA Playoffs - Round 2 - Home Game D,9,31260,1595,-29665,34:56.5,2
6/17/2021,20PNR2GD,2021 NBA Playoffs - Round 2 - Home Game D,A,0,16770,16770,33:02.3,1
6/17/2021,20PNR2GD,2021 NBA Playoffs - Round 2 - Home Game D,A,16770,29570,12800,16:58.8,2
6/17/2021,20PNR2GD,2021 NBA Playoffs - Round 2 - Home Game D,A,29570,1510,-28060,34:56.5,3
6/17/2021,20PNR2GD,2021 NBA Playoffs - Round 2 - Home Game D,B,0,16125,16125,33:02.4,1
6/17/2021,20PNR2GD,2021 NBA Playoffs - Round 2 - Home Game D,B,16125,26880,10755,16:58.9,2
6/17/2021,20PNR2GD,2021 NBA Playoffs - Round 2 - Home Game D,B,26880,1370,-25510,34:56.5,3
6/17/2021,20PNR2GD,2021 NBA Playoffs - Round 2 - Home Game D,C,0,15050,15050,33:02.5,1
6/17/2021,20PNR2GD,2021 NBA Playoffs - Round 2 - Home Game D,C,15050,24590,9540,16:59.0,2
6/17/2021,20PNR2GD,2021 NBA Playoffs - Round 2 - Home Game D,C,24590,1255,-23335,34:56.5,3
6/17/2021,20PNR2GD,2021 NBA Playoffs - Round 2 - Home Game D,D,0,14190,14190,33:02.6,1
6/17/2021,20PNR2GD,2021 NBA Playoffs - Round 2 - Home Game D,D,14190,23530,9340,16:59.1,2
6/17/2021,20PNR2GD,2021 NBA Playoffs - Round 2 - Home Game D,D,23530,1200,-22330,34:56.5,3
6/17/2021,20PNR2GD,2021 NBA Playoffs - Round 2 - Home Game D,E,0,13330,13330,33:02.7,1
6/17/2021,20PNR2GD,2021 NBA Playoffs - Round 2 - Home Game D,E,13330,19750,6420,16:59.2,2
6/17/2021,20PNR2GD,2021 NBA Playoffs - Round 2 - Home Game D,E,19750,1005,-18745,34:56.5,3
6/17/2021,20PNR2GD,2021 NBA Playoffs - Round 2 - Home Game D,F,0,11395,11395,33:02.8,1
6/17/2021,20PNR2GD,2021 NBA Playoffs - Round 2 - Home Game D,F,11395,18710,7315,16:59.2,2
6/17/2021,20PNR2GD,2021 NBA Playoffs - Round 2 - Home Game D,F,18710,955,-17755,34:56.5,3
6/17/2021,20PNR2GD,2021 NBA Playoffs - Round 2 - Home Game D,G,0,10965,10965,33:02.9,1
6/17/2021,20PNR2GD,2021 NBA Playoffs - Round 2 - Home Game D,G,10965,17090,6125,16:59.4,2
6/17/2021,20PNR2GD,2021 NBA Playoffs - Round 2 - Home Game D,G,17090,870,-16220,34:56.5,3
6/17/2021,20PNR2GD,2021 NBA Playoffs - Round 2 - Home Game D,H,0,10535,10535,33:03.1,1
6/17/2021,20PNR2GD,2021 NBA Playoffs - Round 2 - Home Game D,H,10535,15770,5235,16:59.4,2
6/17/2021,20PNR2GD,2021 NBA Playoffs - Round 2 - Home Game D,H,15770,805,-14965,34:56.5,3
6/17/2021,20PNR2GD,2021 NBA Playoffs - Round 2 - Home Game D,I,0,9030,9030,33:03.2,1
6/17/2021,20PNR2GD,2021 NBA Playoffs - Round 2 - Home Game D,I,9030,14180,5150,16:59.5,2
6/17/2021,20PNR2GD,2021 NBA Playoffs - Round 2 - Home Game D,I,14180,725,-13455,34:56.5,3
6/17/2021,20PNR2GD,2021 NBA Playoffs - Round 2 - Home Game D,J,0,8385,8385,33:03.3,1
6/17/2021,20PNR2GD,2021 NBA Playoffs - Round 2 - Home Game D,J,8385,13080,4695,16:59.6,2
6/17/2021,20PNR2GD,2021 NBA Playoffs - Round 2 - Home Game D,J,13080,665,-12415,34:56.5,3
6/17/2021,20PNR2GD,2021 NBA Playoffs - Round 2 - Home Game D,K,0,6880,6880,33:03.4,1
6/17/2021,20PNR2GD,2021 NBA Playoffs - Round 2 - Home Game D,K,6880,12160,5280,16:59.7,2
6/17/2021,20PNR2GD,2021 NBA Playoffs - Round 2 - Home Game D,K,12160,620,-11540,34:56.5,3
6/17/2021,20PNR2GD,2021 NBA Playoffs - Round 2 - Home Game D,L,0,6450,6450,33:03.5,1
6/17/2021,20PNR2GD,2021 NBA Playoffs - Round 2 - Home Game D,L,6450,11930,5480,16:59.8,2
6/17/2021,20PNR2GD,2021 NBA Playoffs - Round 2 - Home Game D,L,11930,610,-11320,34:56.5,3
6/17/2021,20PNR2GD,2021 NBA Playoffs - Round 2 - Home Game D,M,0,6020,6020,33:03.6,1
6/17/2021,20PNR2GD,2021 NBA Playoffs - Round 2 - Home Game D,M,6020,10470,4450,16:59.9,2
6/17/2021,20PNR2GD,2021 NBA Playoffs - Round 2 - Home Game D,M,10470,535,-9935,34:56.5,3
6/17/2021,20PNR2GD,2021 NBA Playoffs - Round 2 - Home Game D,N,0,10105,10105,33:03.7,1
6/17/2021,20PNR2GD,2021 NBA Playoffs - Round 2 - Home Game D,N,10105,17290,7185,17:00.0,2
6/17/2021,20PNR2GD,2021 NBA Playoffs - Round 2 - Home Game D,N,17290,880,-16410,34:56.5,3
6/17/2021,20PNR2GD,2021 NBA Playoffs - Round 2 - Home Game D,O,0,9460,9460,33:03.8,1
6/17/2021,20PNR2GD,2021 NBA Playoffs - Round 2 - Home Game D,O,9460,15550,6090,17:00.1,2
6/17/2021,20PNR2GD,2021 NBA Playoffs - Round 2 - Home Game D,O,15550,795,-14755,34:56.5,3
6/17/2021,20PNR2GD,2021 NBA Playoffs - Round 2 - Home Game D,P,0,7740,7740,33:03.9,1
6/17/2021,20PNR2GD,2021 NBA Playoffs - Round 2 - Home Game D,P,7740,13670,5930,17:00.3,2
6/17/2021,20PNR2GD,2021 NBA Playoffs - Round 2 - Home Game D,P,13670,695,-12975,34:56.5,3
6/17/2021,20PNR2GD,2021 NBA Playoffs - Round 2 - Home Game D,Q,0,6880,6880,33:04.0,1
6/17/2021,20PNR2GD,2021 NBA Playoffs - Round 2 - Home Game D,Q,6880,10960,4080,17:00.4,2
6/17/2021,20PNR2GD,2021 NBA Playoffs - Round 2 - Home Game D,Q,10960,560,-10400,34:56.5,3
6/17/2021,20PNR2GD,2021 NBA Playoffs - Round 2 - Home Game D,R,0,5590,5590,33:04.1,1
6/17/2021,20PNR2GD,2021 NBA Playoffs - Round 2 - Home Game D,R,5590,9740,4150,17:00.5,2
6/17/2021,20PNR2GD,2021 NBA Playoffs - Round 2 - Home Game D,R,9740,495,-9245,34:56.5,3
6/17/2021,20PNR2GD,2021 NBA Playoffs - Round 2 - Home Game D,S,0,5590,5590,33:04.2,1
6/17/2021,20PNR2GD,2021 NBA Playoffs - Round 2 - Home Game D,S,5590,9740,4150,17:00.6,2
6/17/2021,20PNR2GD,2021 NBA Playoffs - Round 2 - Home Game D,S,9740,495,-9245,34:56.5,3
6/17/2021,20PNR2GD,2021 NBA Playoffs - Round 2 - Home Game D,T,0,4730,4730,33:04.3,1
6/17/2021,20PNR2GD,2021 NBA Playoffs - Round 2 - Home Game D,T,4730,8030,3300,17:00.7,2
6/17/2021,20PNR2GD,2021 NBA Playoffs - Round 2 - Home Game D,T,8030,410,-7620,34:56.5,3
6/17/2021,20PNR2GD,2021 NBA Playoffs - Round 2 - Home Game D,U,0,3870,3870,33:04.4,1
6/17/2021,20PNR2GD,2021 NBA Playoffs - Round 2 - Home Game D,U,3870,7130,3260,17:00.8,2
6/17/2021,20PNR2GD,2021 NBA Playoffs - Round 2 - Home Game D,U,7130,365,-6765,34:56.5,3
6/17/2021,20PNR2GD,2021 NBA Playoffs - Round 2 - Home Game D,V,0,3440,3440,33:04.5,1
6/17/2021,20PNR2GD,2021 NBA Playoffs - Round 2 - Home Game D,V,3440,6430,2990,17:00.8,2
6/17/2021,20PNR2GD,2021 NBA Playoffs - Round 2 - Home Game D,V,6430,330,-6100,34:56.5,3
6/17/2021,20PNR2GD,2021 NBA Playoffs - Round 2 - Home Game D,W,0,3010,3010,33:04.6,1
6/17/2021,20PNR2GD,2021 NBA Playoffs - Round 2 - Home Game D,W,3010,6030,3020,17:00.9,2
6/17/2021,20PNR2GD,2021 NBA Playoffs - Round 2 - Home Game D,W,6030,305,-5725,34:56.5,3
6/17/2021,20PNR2GD,2021 NBA Playoffs - Round 2 - Home Game D,X,0,2795,2795,33:04.8,1
6/17/2021,20PNR2GD,2021 NBA Playoffs - Round 2 - Home Game D,X,2795,5370,2575,17:01.0,2
6/17/2021,20PNR2GD,2021 NBA Playoffs - Round 2 - Home Game D,X,5370,275,-5095,34:56.5,3
6/17/2021,20PNR2GD,2021 NBA Playoffs - Round 2 - Home Game D,Y,0,2795,2795,33:04.9,1
6/17/2021,20PNR2GD,2021 NBA Playoffs - Round 2 - Home Game D,Y,2795,5220,2425,17:01.1,2
6/17/2021,20PNR2GD,2021 NBA Playoffs - Round 2 - Home Game D,Y,5220,265,-4955,34:56.5,3
6/17/2021,20PNR2GD,2021 NBA Playoffs - Round 2 - Home Game D,Z,0,999999,999999,33:05.0,1
6/17/2021,20PNR2GD,2021 NBA Playoffs - Round 2 - Home Game D,Z,999999,20190,-979809,17:01.2,2
6/17/2021,20PNR2GD,2021 NBA Playoffs - Round 2 - Home Game D,Z,20190,1030,-19160,34:56.5,3
6/17/2021,20PNR2VD,2021 NBA Playoffs - Round 2 - Home Game D,1,0,8800,8800,27:22.7,1
6/17/2021,20PNR2VD,2021 NBA Playoffs - Round 2 - Home Game D,1,8800,8000,-800,52:04.8,2
6/17/2021,20PNR2VD,2021 NBA Playoffs - Round 2 - Home Game D,1,8000,9000,1000,52:19.2,3
6/17/2021,20PNR2VD,2021 NBA Playoffs - Round 2 - Home Game D,2,0,8800,8800,27:22.8,1
6/17/2021,20PNR2VD,2021 NBA Playoffs - Round 2 - Home Game D,2,8800,8000,-800,52:04.8,2
6/17/2021,20PNR2VD,2021 NBA Playoffs - Round 2 - Home Game D,2,8000,9000,1000,52:19.2,3
6/17/2021,20PNR2VD,2021 NBA Playoffs - Round 2 - Home Game D,3,0,8800,8800,27:22.9,1
6/17/2021,20PNR2VD,2021 NBA Playoffs - Round 2 - Home Game D,3,8800,8000,-800,52:04.8,2
6/17/2021,20PNR2VD,2021 NBA Playoffs - Round 2 - Home Game D,3,8000,9000,1000,52:19.2,3
6/17/2021,20PNR2VD,2021 NBA Playoffs - Round 2 - Home Game D,4,0,6400,6400,27:23.0,1
6/17/2021,20PNR2VD,2021 NBA Playoffs - Round 2 - Home Game D,4,6400,8000,1600,52:04.8,2
6/17/2021,20PNR2VD,2021 NBA Playoffs - Round 2 - Home Game D,4,8000,9000,1000,52:19.2,3
6/17/2021,20PNR2VD,2021 NBA Playoffs - Round 2 - Home Game D,5,0,3240,3240,27:23.1,1
6/17/2021,20PNR2VD,2021 NBA Playoffs - Round 2 - Home Game D,5,3240,5000,1760,52:04.8,2
6/17/2021,20PNR2VD,2021 NBA Playoffs - Round 2 - Home Game D,5,5000,1950,-3050,52:19.2,3
6/17/2021,20PNR2VD,2021 NBA Playoffs - Round 2 - Home Game D,6,0,2425,2425,27:23.2,1
6/17/2021,20PNR2VD,2021 NBA Playoffs - Round 2 - Home Game D,6,2425,5000,2575,52:04.8,2
6/17/2021,20PNR2VD,2021 NBA Playoffs - Round 2 - Home Game D,6,5000,1640,-3360,52:19.2,3
6/17/2021,20PNR2VD,2021 NBA Playoffs - Round 2 - Home Game D,7,2365,5000,2635,52:04.8,1
6/17/2021,20PNR2VD,2021 NBA Playoffs - Round 2 - Home Game D,7,5000,1280,-3720,52:19.2,2
6/17/2021,20PNR2VD,2021 NBA Playoffs - Round 2 - Home Game D,8,1655,1070,-585,52:04.8,1
6/17/2021,20PNR2VD,2021 NBA Playoffs - Round 2 - Home Game D,9,1595,1030,-565,52:04.8,1
6/17/2021,20PNR2VD,2021 NBA Playoffs - Round 2 - Home Game D,A,0,1510,1510,27:23.3,1
6/17/2021,20PNR2VD,2021 NBA Playoffs - Round 2 - Home Game D,A,1510,980,-530,52:04.8,2
6/17/2021,20PNR2VD,2021 NBA Playoffs - Round 2 - Home Game D,B,0,1370,1370,27:23.4,1
6/17/2021,20PNR2VD,2021 NBA Playoffs - Round 2 - Home Game D,B,1370,890,-480,52:04.8,2
6/17/2021,20PNR2VD,2021 NBA Playoffs - Round 2 - Home Game D,C,0,1255,1255,27:23.5,1
6/17/2021,20PNR2VD,2021 NBA Playoffs - Round 2 - Home Game D,C,1255,825,-430,52:04.8,2
6/17/2021,20PNR2VD,2021 NBA Playoffs - Round 2 - Home Game D,D,0,1200,1200,27:23.6,1
6/17/2021,20PNR2VD,2021 NBA Playoffs - Round 2 - Home Game D,D,1200,790,-410,52:04.8,2
6/17/2021,20PNR2VD,2021 NBA Playoffs - Round 2 - Home Game D,E,0,1005,1005,27:23.7,1
6/17/2021,20PNR2VD,2021 NBA Playoffs - Round 2 - Home Game D,E,1005,660,-345,52:04.8,2
6/17/2021,20PNR2VD,2021 NBA Playoffs - Round 2 - Home Game D,F,0,955,955,27:23.8,1
6/17/2021,20PNR2VD,2021 NBA Playoffs - Round 2 - Home Game D,F,955,635,-320,52:04.8,2
6/17/2021,20PNR2VD,2021 NBA Playoffs - Round 2 - Home Game D,G,0,870,870,27:24.0,1
6/17/2021,20PNR2VD,2021 NBA Playoffs - Round 2 - Home Game D,G,870,585,-285,52:04.8,2
6/17/2021,20PNR2VD,2021 NBA Playoffs - Round 2 - Home Game D,H,0,805,805,27:24.1,1
6/17/2021,20PNR2VD,2021 NBA Playoffs - Round 2 - Home Game D,H,805,535,-270,52:04.8,2
6/17/2021,20PNR2VD,2021 NBA Playoffs - Round 2 - Home Game D,I,0,725,725,27:24.2,1
6/17/2021,20PNR2VD,2021 NBA Playoffs - Round 2 - Home Game D,I,725,485,-240,52:04.8,2
6/17/2021,20PNR2VD,2021 NBA Playoffs - Round 2 - Home Game D,J,0,665,665,27:24.3,1
6/17/2021,20PNR2VD,2021 NBA Playoffs - Round 2 - Home Game D,J,665,460,-205,52:04.8,2
6/17/2021,20PNR2VD,2021 NBA Playoffs - Round 2 - Home Game D,K,0,620,620,27:24.5,1
6/17/2021,20PNR2VD,2021 NBA Playoffs - Round 2 - Home Game D,K,620,430,-190,52:04.8,2
6/17/2021,20PNR2VD,2021 NBA Playoffs - Round 2 - Home Game D,L,0,610,610,27:24.6,1
6/17/2021,20PNR2VD,2021 NBA Playoffs - Round 2 - Home Game D,L,610,420,-190,52:04.8,2
6/17/2021,20PNR2VD,2021 NBA Playoffs - Round 2 - Home Game D,M,0,535,535,27:24.8,1
6/17/2021,20PNR2VD,2021 NBA Playoffs - Round 2 - Home Game D,M,535,370,-165,52:04.8,2
6/17/2021,20PNR2VD,2021 NBA Playoffs - Round 2 - Home Game D,N,0,880,880,27:24.9,1
6/17/2021,20PNR2VD,2021 NBA Playoffs - Round 2 - Home Game D,N,880,610,-270,52:04.8,2
6/17/2021,20PNR2VD,2021 NBA Playoffs - Round 2 - Home Game D,O,0,795,795,27:25.1,1
6/17/2021,20PNR2VD,2021 NBA Playoffs - Round 2 - Home Game D,O,795,545,-250,52:04.8,2
6/17/2021,20PNR2VD,2021 NBA Playoffs - Round 2 - Home Game D,P,0,695,695,27:25.2,1
6/17/2021,20PNR2VD,2021 NBA Playoffs - Round 2 - Home Game D,P,695,475,-220,52:04.8,2
6/17/2021,20PNR2VD,2021 NBA Playoffs - Round 2 - Home Game D,Q,0,560,560,27:25.4,1
6/17/2021,20PNR2VD,2021 NBA Playoffs - Round 2 - Home Game D,Q,560,390,-170,52:04.8,2
6/17/2021,20PNR2VD,2021 NBA Playoffs - Round 2 - Home Game D,R,0,495,495,27:25.6,1
6/17/2021,20PNR2VD,2021 NBA Playoffs - Round 2 - Home Game D,R,495,340,-155,52:04.8,2
6/17/2021,20PNR2VD,2021 NBA Playoffs - Round 2 - Home Game D,S,0,495,495,27:25.7,1
6/17/2021,20PNR2VD,2021 NBA Playoffs - Round 2 - Home Game D,S,495,340,-155,52:04.8,2
6/17/2021,20PNR2VD,2021 NBA Playoffs - Round 2 - Home Game D,T,0,410,410,27:25.9,1
6/17/2021,20PNR2VD,2021 NBA Playoffs - Round 2 - Home Game D,T,410,290,-120,52:04.8,2
6/17/2021,20PNR2VD,2021 NBA Playoffs - Round 2 - Home Game D,U,0,365,365,27:26.1,1
6/17/2021,20PNR2VD,2021 NBA Playoffs - Round 2 - Home Game D,U,365,265,-100,52:04.8,2
6/17/2021,20PNR2VD,2021 NBA Playoffs - Round 2 - Home Game D,V,0,330,330,27:26.2,1
6/17/2021,20PNR2VD,2021 NBA Playoffs - Round 2 - Home Game D,V,330,230,-100,52:04.8,2
6/17/2021,20PNR2VD,2021 NBA Playoffs - Round 2 - Home Game D,W,0,305,305,27:26.4,1
6/17/2021,20PNR2VD,2021 NBA Playoffs - Round 2 - Home Game D,W,305,215,-90,52:04.8,2
6/17/2021,20PNR2VD,2021 NBA Playoffs - Round 2 - Home Game D,X,0,275,275,27:26.5,1
6/17/2021,20PNR2VD,2021 NBA Playoffs - Round 2 - Home Game D,X,275,195,-80,52:04.8,2
6/17/2021,20PNR2VD,2021 NBA Playoffs - Round 2 - Home Game D,Y,0,265,265,27:26.7,1
6/17/2021,20PNR2VD,2021 NBA Playoffs - Round 2 - Home Game D,Y,265,185,-80,52:04.8,2
6/17/2021,20PNR2VD,2021 NBA Playoffs - Round 2 - Home Game D,Z,0,1030,1030,27:26.8,1
6/17/2021,20PNR2VD,2021 NBA Playoffs - Round 2 - Home Game D,Z,1030,590,-440,52:04.8,2
6/20/2021,20PNR3GA,2021 NBA Playoffs - Round 3 - Home Game A,1,0,236500,236500,33:05.1,1
6/20/2021,20PNR3GA,2021 NBA Playoffs - Round 3 - Home Game A,1,236500,157500,-79000,17:01.3,2
6/20/2021,20PNR3GA,2021 NBA Playoffs - Round 3 - Home Game A,1,157500,10285,-147215,34:56.5,3
6/20/2021,20PNR3GA,2021 NBA Playoffs - Round 3 - Home Game A,2,0,98900,98900,33:05.2,1
6/20/2021,20PNR3GA,2021 NBA Playoffs - Round 3 - Home Game A,2,98900,10285,-88615,34:56.5,2
6/20/2021,20PNR3GA,2021 NBA Playoffs - Round 3 - Home Game A,3,0,85979,85979,33:05.3,1
6/20/2021,20PNR3GA,2021 NBA Playoffs - Round 3 - Home Game A,3,85979,157500,71521,17:01.4,2
6/20/2021,20PNR3GA,2021 NBA Playoffs - Round 3 - Home Game A,3,157500,10285,-147215,34:56.5,3
6/20/2021,20PNR3GA,2021 NBA Playoffs - Round 3 - Home Game A,4,0,47300,47300,33:05.4,1
6/20/2021,20PNR3GA,2021 NBA Playoffs - Round 3 - Home Game A,4,47300,114540,67240,17:01.5,2
6/20/2021,20PNR3GA,2021 NBA Playoffs - Round 3 - Home Game A,4,114540,7480,-107060,34:56.5,3
6/20/2021,20PNR3GA,2021 NBA Playoffs - Round 3 - Home Game A,5,0,43000,43000,33:05.5,1
6/20/2021,20PNR3GA,2021 NBA Playoffs - Round 3 - Home Game A,5,43000,59120,16120,17:01.6,2
6/20/2021,20PNR3GA,2021 NBA Playoffs - Round 3 - Home Game A,5,59120,4060,-55060,34:56.5,3
6/20/2021,20PNR3GA,2021 NBA Playoffs - Round 3 - Home Game A,5,4060,3770,-290,54:56.8,4
6/20/2021,20PNR3GA,2021 NBA Playoffs - Round 3 - Home Game A,5,4060,3770,-290,54:56.8,5
6/20/2021,20PNR3GA,2021 NBA Playoffs - Round 3 - Home Game A,6,0,30100,30100,33:05.6,1
6/20/2021,20PNR3GA,2021 NBA Playoffs - Round 3 - Home Game A,6,30100,41100,11000,17:01.7,2
6/20/2021,20PNR3GA,2021 NBA Playoffs - Round 3 - Home Game A,6,41100,2825,-38275,34:56.5,3
6/20/2021,20PNR3GA,2021 NBA Playoffs - Round 3 - Home Game A,7,23650,38610,14960,17:01.8,1
6/20/2021,20PNR3GA,2021 NBA Playoffs - Round 3 - Home Game A,7,38610,2650,-35960,34:56.5,2
6/20/2021,20PNR3GA,2021 NBA Playoffs - Round 3 - Home Game A,7,2650,2750,100,54:56.8,3
6/20/2021,20PNR3GA,2021 NBA Playoffs - Round 3 - Home Game A,7,2650,2750,100,54:56.8,4
6/20/2021,20PNR3GA,2021 NBA Playoffs - Round 3 - Home Game A,8,18275,32420,14145,17:01.9,1
6/20/2021,20PNR3GA,2021 NBA Playoffs - Round 3 - Home Game A,8,32420,1925,-30495,34:56.5,2
6/20/2021,20PNR3GA,2021 NBA Playoffs - Round 3 - Home Game A,9,17630,31260,13630,17:02.0,1
6/20/2021,20PNR3GA,2021 NBA Playoffs - Round 3 - Home Game A,9,31260,1855,-29405,34:56.5,2
6/20/2021,20PNR3GA,2021 NBA Playoffs - Round 3 - Home Game A,A,0,16770,16770,33:05.7,1
6/20/2021,20PNR3GA,2021 NBA Playoffs - Round 3 - Home Game A,A,16770,29570,12800,17:02.1,2
6/20/2021,20PNR3GA,2021 NBA Playoffs - Round 3 - Home Game A,A,29570,1755,-27815,34:56.5,3
6/20/2021,20PNR3GA,2021 NBA Playoffs - Round 3 - Home Game A,B,0,16125,16125,33:05.8,1
6/20/2021,20PNR3GA,2021 NBA Playoffs - Round 3 - Home Game A,B,16125,26880,10755,17:02.2,2
6/20/2021,20PNR3GA,2021 NBA Playoffs - Round 3 - Home Game A,B,26880,1595,-25285,34:56.5,3
6/20/2021,20PNR3GA,2021 NBA Playoffs - Round 3 - Home Game A,C,0,15050,15050,33:05.9,1
6/20/2021,20PNR3GA,2021 NBA Playoffs - Round 3 - Home Game A,C,15050,24590,9540,17:02.3,2
6/20/2021,20PNR3GA,2021 NBA Playoffs - Round 3 - Home Game A,C,24590,1460,-23130,34:56.5,3
6/20/2021,20PNR3GA,2021 NBA Playoffs - Round 3 - Home Game A,D,0,14190,14190,33:06.0,1
6/20/2021,20PNR3GA,2021 NBA Playoffs - Round 3 - Home Game A,D,14190,23530,9340,17:02.4,2
6/20/2021,20PNR3GA,2021 NBA Playoffs - Round 3 - Home Game A,D,23530,1395,-22135,34:56.5,3
6/20/2021,20PNR3GA,2021 NBA Playoffs - Round 3 - Home Game A,E,0,13330,13330,33:06.2,1
6/20/2021,20PNR3GA,2021 NBA Playoffs - Round 3 - Home Game A,E,13330,19750,6420,17:02.5,2
6/20/2021,20PNR3GA,2021 NBA Playoffs - Round 3 - Home Game A,E,19750,1170,-18580,34:56.5,3
6/20/2021,20PNR3GA,2021 NBA Playoffs - Round 3 - Home Game A,F,0,11395,11395,33:06.3,1
6/20/2021,20PNR3GA,2021 NBA Playoffs - Round 3 - Home Game A,F,11395,18710,7315,17:02.6,2
6/20/2021,20PNR3GA,2021 NBA Playoffs - Round 3 - Home Game A,F,18710,1110,-17600,34:56.5,3
6/20/2021,20PNR3GA,2021 NBA Playoffs - Round 3 - Home Game A,G,0,10965,10965,33:06.4,1
6/20/2021,20PNR3GA,2021 NBA Playoffs - Round 3 - Home Game A,G,10965,17090,6125,17:02.7,2
6/20/2021,20PNR3GA,2021 NBA Playoffs - Round 3 - Home Game A,G,17090,1015,-16075,34:56.5,3
6/20/2021,20PNR3GA,2021 NBA Playoffs - Round 3 - Home Game A,H,0,10535,10535,33:06.5,1
6/20/2021,20PNR3GA,2021 NBA Playoffs - Round 3 - Home Game A,H,10535,15770,5235,17:02.8,2
6/20/2021,20PNR3GA,2021 NBA Playoffs - Round 3 - Home Game A,H,15770,935,-14835,34:56.5,3
6/20/2021,20PNR3GA,2021 NBA Playoffs - Round 3 - Home Game A,I,0,9030,9030,33:06.6,1
6/20/2021,20PNR3GA,2021 NBA Playoffs - Round 3 - Home Game A,I,9030,14180,5150,17:02.8,2
6/20/2021,20PNR3GA,2021 NBA Playoffs - Round 3 - Home Game A,I,14180,840,-13340,34:56.5,3
6/20/2021,20PNR3GA,2021 NBA Playoffs - Round 3 - Home Game A,J,0,8385,8385,33:06.7,1
6/20/2021,20PNR3GA,2021 NBA Playoffs - Round 3 - Home Game A,J,8385,13080,4695,17:02.9,2
6/20/2021,20PNR3GA,2021 NBA Playoffs - Round 3 - Home Game A,J,13080,775,-12305,34:56.5,3
6/20/2021,20PNR3GA,2021 NBA Playoffs - Round 3 - Home Game A,K,0,6880,6880,33:06.8,1
6/20/2021,20PNR3GA,2021 NBA Playoffs - Round 3 - Home Game A,K,6880,12160,5280,17:03.0,2
6/20/2021,20PNR3GA,2021 NBA Playoffs - Round 3 - Home Game A,K,12160,720,-11440,34:56.5,3
6/20/2021,20PNR3GA,2021 NBA Playoffs - Round 3 - Home Game A,L,0,6450,6450,33:06.9,1
6/20/2021,20PNR3GA,2021 NBA Playoffs - Round 3 - Home Game A,L,6450,11930,5480,17:03.1,2
6/20/2021,20PNR3GA,2021 NBA Playoffs - Round 3 - Home Game A,L,11930,705,-11225,34:56.5,3
6/20/2021,20PNR3GA,2021 NBA Playoffs - Round 3 - Home Game A,M,0,6020,6020,33:07.0,1
6/20/2021,20PNR3GA,2021 NBA Playoffs - Round 3 - Home Game A,M,6020,10470,4450,17:03.2,2
6/20/2021,20PNR3GA,2021 NBA Playoffs - Round 3 - Home Game A,M,10470,620,-9850,34:56.5,3
6/20/2021,20PNR3GA,2021 NBA Playoffs - Round 3 - Home Game A,N,0,10105,10105,33:07.1,1
6/20/2021,20PNR3GA,2021 NBA Playoffs - Round 3 - Home Game A,N,10105,17290,7185,17:03.3,2
6/20/2021,20PNR3GA,2021 NBA Playoffs - Round 3 - Home Game A,N,17290,1025,-16265,34:56.5,3
6/20/2021,20PNR3GA,2021 NBA Playoffs - Round 3 - Home Game A,O,0,9460,9460,33:07.2,1
6/20/2021,20PNR3GA,2021 NBA Playoffs - Round 3 - Home Game A,O,9460,15550,6090,17:03.4,2
6/20/2021,20PNR3GA,2021 NBA Playoffs - Round 3 - Home Game A,O,15550,920,-14630,34:56.5,3
6/20/2021,20PNR3GA,2021 NBA Playoffs - Round 3 - Home Game A,P,0,7740,7740,33:07.3,1
6/20/2021,20PNR3GA,2021 NBA Playoffs - Round 3 - Home Game A,P,7740,13670,5930,17:03.5,2
6/20/2021,20PNR3GA,2021 NBA Playoffs - Round 3 - Home Game A,P,13670,810,-12860,34:56.5,3
6/20/2021,20PNR3GA,2021 NBA Playoffs - Round 3 - Home Game A,Q,0,6880,6880,33:07.4,1
6/20/2021,20PNR3GA,2021 NBA Playoffs - Round 3 - Home Game A,Q,6880,10960,4080,17:03.6,2
6/20/2021,20PNR3GA,2021 NBA Playoffs - Round 3 - Home Game A,Q,10960,650,-10310,34:56.5,3
6/20/2021,20PNR3GA,2021 NBA Playoffs - Round 3 - Home Game A,R,0,5590,5590,33:07.5,1
6/20/2021,20PNR3GA,2021 NBA Playoffs - Round 3 - Home Game A,R,5590,9740,4150,17:03.7,2
6/20/2021,20PNR3GA,2021 NBA Playoffs - Round 3 - Home Game A,R,9740,580,-9160,34:56.5,3
6/20/2021,20PNR3GA,2021 NBA Playoffs - Round 3 - Home Game A,S,0,5590,5590,33:07.6,1
6/20/2021,20PNR3GA,2021 NBA Playoffs - Round 3 - Home Game A,S,5590,9740,4150,17:03.7,2
6/20/2021,20PNR3GA,2021 NBA Playoffs - Round 3 - Home Game A,S,9740,580,-9160,34:56.5,3
6/20/2021,20PNR3GA,2021 NBA Playoffs - Round 3 - Home Game A,T,0,4730,4730,33:07.7,1
6/20/2021,20PNR3GA,2021 NBA Playoffs - Round 3 - Home Game A,T,4730,8030,3300,17:03.8,2
6/20/2021,20PNR3GA,2021 NBA Playoffs - Round 3 - Home Game A,T,8030,475,-7555,34:56.5,3
6/20/2021,20PNR3GA,2021 NBA Playoffs - Round 3 - Home Game A,U,0,3870,3870,33:07.8,1
6/20/2021,20PNR3GA,2021 NBA Playoffs - Round 3 - Home Game A,U,3870,7130,3260,17:03.9,2
6/20/2021,20PNR3GA,2021 NBA Playoffs - Round 3 - Home Game A,U,7130,425,-6705,34:56.5,3
6/20/2021,20PNR3GA,2021 NBA Playoffs - Round 3 - Home Game A,V,0,3440,3440,33:07.9,1
6/20/2021,20PNR3GA,2021 NBA Playoffs - Round 3 - Home Game A,V,3440,6430,2990,17:04.0,2
6/20/2021,20PNR3GA,2021 NBA Playoffs - Round 3 - Home Game A,V,6430,380,-6050,34:56.5,3
6/20/2021,20PNR3GA,2021 NBA Playoffs - Round 3 - Home Game A,W,0,3010,3010,33:08.0,1
6/20/2021,20PNR3GA,2021 NBA Playoffs - Round 3 - Home Game A,W,3010,6030,3020,17:04.1,2
6/20/2021,20PNR3GA,2021 NBA Playoffs - Round 3 - Home Game A,W,6030,360,-5670,34:56.5,3
6/20/2021,20PNR3GA,2021 NBA Playoffs - Round 3 - Home Game A,X,0,2795,2795,33:08.1,1
6/20/2021,20PNR3GA,2021 NBA Playoffs - Round 3 - Home Game A,X,2795,5370,2575,17:04.2,2
6/20/2021,20PNR3GA,2021 NBA Playoffs - Round 3 - Home Game A,X,5370,320,-5050,34:56.5,3
6/20/2021,20PNR3GA,2021 NBA Playoffs - Round 3 - Home Game A,Y,0,2795,2795,33:08.2,1
6/20/2021,20PNR3GA,2021 NBA Playoffs - Round 3 - Home Game A,Y,2795,5220,2425,17:04.3,2
6/20/2021,20PNR3GA,2021 NBA Playoffs - Round 3 - Home Game A,Y,5220,310,-4910,34:56.5,3
6/20/2021,20PNR3GA,2021 NBA Playoffs - Round 3 - Home Game A,Z,0,999999,999999,33:08.3,1
6/20/2021,20PNR3GA,2021 NBA Playoffs - Round 3 - Home Game A,Z,999999,20190,-979809,17:04.4,2
6/20/2021,20PNR3GA,2021 NBA Playoffs - Round 3 - Home Game A,Z,20190,1195,-18995,34:56.5,3
6/20/2021,20PNR3VA,2021 NBA Playoffs - Round 3 - Home Game A,1,0,10285,10285,31:17.8,1
6/20/2021,20PNR3VA,2021 NBA Playoffs - Round 3 - Home Game A,2,0,10285,10285,31:17.9,1
6/20/2021,20PNR3VA,2021 NBA Playoffs - Round 3 - Home Game A,3,0,10285,10285,31:18.0,1
6/20/2021,20PNR3VA,2021 NBA Playoffs - Round 3 - Home Game A,4,0,7480,7480,31:18.1,1
6/20/2021,20PNR3VA,2021 NBA Playoffs - Round 3 - Home Game A,5,0,3770,3770,31:18.2,1
6/20/2021,20PNR3VA,2021 NBA Playoffs - Round 3 - Home Game A,6,0,2825,2825,31:18.3,1
6/20/2021,20PNR3VA,2021 NBA Playoffs - Round 3 - Home Game A,A,0,1755,1755,31:18.4,1
6/20/2021,20PNR3VA,2021 NBA Playoffs - Round 3 - Home Game A,B,0,1595,1595,31:18.5,1
6/20/2021,20PNR3VA,2021 NBA Playoffs - Round 3 - Home Game A,C,0,1460,1460,31:18.6,1
6/20/2021,20PNR3VA,2021 NBA Playoffs - Round 3 - Home Game A,D,0,1395,1395,31:18.7,1
6/20/2021,20PNR3VA,2021 NBA Playoffs - Round 3 - Home Game A,E,0,1170,1170,31:18.8,1
6/20/2021,20PNR3VA,2021 NBA Playoffs - Round 3 - Home Game A,F,0,1110,1110,31:18.9,1
6/20/2021,20PNR3VA,2021 NBA Playoffs - Round 3 - Home Game A,G,0,1015,1015,31:19.0,1
6/20/2021,20PNR3VA,2021 NBA Playoffs - Round 3 - Home Game A,H,0,935,935,31:19.1,1
6/20/2021,20PNR3VA,2021 NBA Playoffs - Round 3 - Home Game A,I,0,840,840,31:19.2,1
6/20/2021,20PNR3VA,2021 NBA Playoffs - Round 3 - Home Game A,J,0,775,775,31:19.3,1
6/20/2021,20PNR3VA,2021 NBA Playoffs - Round 3 - Home Game A,K,0,720,720,31:19.4,1
6/20/2021,20PNR3VA,2021 NBA Playoffs - Round 3 - Home Game A,L,0,705,705,31:19.6,1
6/20/2021,20PNR3VA,2021 NBA Playoffs - Round 3 - Home Game A,M,0,620,620,31:19.6,1
6/20/2021,20PNR3VA,2021 NBA Playoffs - Round 3 - Home Game A,N,0,1025,1025,31:19.7,1
6/20/2021,20PNR3VA,2021 NBA Playoffs - Round 3 - Home Game A,O,0,920,920,31:19.8,1
6/20/2021,20PNR3VA,2021 NBA Playoffs - Round 3 - Home Game A,P,0,810,810,31:20.0,1
6/20/2021,20PNR3VA,2021 NBA Playoffs - Round 3 - Home Game A,Q,0,650,650,31:20.1,1
6/20/2021,20PNR3VA,2021 NBA Playoffs - Round 3 - Home Game A,R,0,580,580,31:20.2,1
6/20/2021,20PNR3VA,2021 NBA Playoffs - Round 3 - Home Game A,S,0,580,580,31:20.4,1
6/20/2021,20PNR3VA,2021 NBA Playoffs - Round 3 - Home Game A,T,0,475,475,31:20.4,1
6/20/2021,20PNR3VA,2021 NBA Playoffs - Round 3 - Home Game A,U,0,425,425,31:20.6,1
6/20/2021,20PNR3VA,2021 NBA Playoffs - Round 3 - Home Game A,V,0,380,380,31:20.7,1
6/20/2021,20PNR3VA,2021 NBA Playoffs - Round 3 - Home Game A,W,0,360,360,31:20.8,1
6/20/2021,20PNR3VA,2021 NBA Playoffs - Round 3 - Home Game A,X,0,320,320,31:20.9,1
6/20/2021,20PNR3VA,2021 NBA Playoffs - Round 3 - Home Game A,Y,0,310,310,31:21.0,1
6/20/2021,20PNR3VA,2021 NBA Playoffs - Round 3 - Home Game A,Z,0,1195,1195,31:21.1,1
6/23/2021,20PNR3GB,2021 NBA Playoffs - Round 3 - Home Game B,1,0,236500,236500,33:08.4,1
6/23/2021,20PNR3GB,2021 NBA Playoffs - Round 3 - Home Game B,1,236500,157500,-79000,17:04.5,2
6/23/2021,20PNR3GB,2021 NBA Playoffs - Round 3 - Home Game B,1,157500,10285,-147215,34:56.5,3
6/23/2021,20PNR3GB,2021 NBA Playoffs - Round 3 - Home Game B,2,0,98900,98900,33:08.5,1
6/23/2021,20PNR3GB,2021 NBA Playoffs - Round 3 - Home Game B,2,98900,10285,-88615,34:56.5,2
6/23/2021,20PNR3GB,2021 NBA Playoffs - Round 3 - Home Game B,3,0,85979,85979,33:08.6,1
6/23/2021,20PNR3GB,2021 NBA Playoffs - Round 3 - Home Game B,3,85979,157500,71521,17:04.6,2
6/23/2021,20PNR3GB,2021 NBA Playoffs - Round 3 - Home Game B,3,157500,10285,-147215,34:56.5,3
6/23/2021,20PNR3GB,2021 NBA Playoffs - Round 3 - Home Game B,4,0,47300,47300,33:08.7,1
6/23/2021,20PNR3GB,2021 NBA Playoffs - Round 3 - Home Game B,4,47300,114540,67240,17:04.7,2
6/23/2021,20PNR3GB,2021 NBA Playoffs - Round 3 - Home Game B,4,114540,7480,-107060,34:56.5,3
6/23/2021,20PNR3GB,2021 NBA Playoffs - Round 3 - Home Game B,5,0,43000,43000,33:08.8,1
6/23/2021,20PNR3GB,2021 NBA Playoffs - Round 3 - Home Game B,5,43000,59120,16120,17:04.8,2
6/23/2021,20PNR3GB,2021 NBA Playoffs - Round 3 - Home Game B,5,59120,4060,-55060,34:56.5,3
6/23/2021,20PNR3GB,2021 NBA Playoffs - Round 3 - Home Game B,5,4060,3770,-290,54:56.8,4
6/23/2021,20PNR3GB,2021 NBA Playoffs - Round 3 - Home Game B,5,4060,3770,-290,54:56.8,5
6/23/2021,20PNR3GB,2021 NBA Playoffs - Round 3 - Home Game B,6,0,30100,30100,33:08.9,1
6/23/2021,20PNR3GB,2021 NBA Playoffs - Round 3 - Home Game B,6,30100,41100,11000,17:04.8,2
6/23/2021,20PNR3GB,2021 NBA Playoffs - Round 3 - Home Game B,6,41100,2825,-38275,34:56.5,3
6/23/2021,20PNR3GB,2021 NBA Playoffs - Round 3 - Home Game B,7,23650,38610,14960,17:04.9,1
6/23/2021,20PNR3GB,2021 NBA Playoffs - Round 3 - Home Game B,7,38610,2650,-35960,34:56.5,2
6/23/2021,20PNR3GB,2021 NBA Playoffs - Round 3 - Home Game B,7,2650,2750,100,54:56.8,3
6/23/2021,20PNR3GB,2021 NBA Playoffs - Round 3 - Home Game B,7,2650,2750,100,54:56.8,4
6/23/2021,20PNR3GB,2021 NBA Playoffs - Round 3 - Home Game B,8,18275,32420,14145,17:05.0,1
6/23/2021,20PNR3GB,2021 NBA Playoffs - Round 3 - Home Game B,8,32420,1925,-30495,34:56.5,2
6/23/2021,20PNR3GB,2021 NBA Playoffs - Round 3 - Home Game B,9,17630,31260,13630,17:05.1,1
6/23/2021,20PNR3GB,2021 NBA Playoffs - Round 3 - Home Game B,9,31260,1855,-29405,34:56.5,2
6/23/2021,20PNR3GB,2021 NBA Playoffs - Round 3 - Home Game B,A,0,16770,16770,33:09.0,1
6/23/2021,20PNR3GB,2021 NBA Playoffs - Round 3 - Home Game B,A,16770,29570,12800,17:05.2,2
6/23/2021,20PNR3GB,2021 NBA Playoffs - Round 3 - Home Game B,A,29570,1755,-27815,34:56.5,3
6/23/2021,20PNR3GB,2021 NBA Playoffs - Round 3 - Home Game B,B,0,16125,16125,33:09.1,1
6/23/2021,20PNR3GB,2021 NBA Playoffs - Round 3 - Home Game B,B,16125,26880,10755,17:05.3,2
6/23/2021,20PNR3GB,2021 NBA Playoffs - Round 3 - Home Game B,B,26880,1595,-25285,34:56.5,3
6/23/2021,20PNR3GB,2021 NBA Playoffs - Round 3 - Home Game B,C,0,15050,15050,33:09.2,1
6/23/2021,20PNR3GB,2021 NBA Playoffs - Round 3 - Home Game B,C,15050,24590,9540,17:05.4,2
6/23/2021,20PNR3GB,2021 NBA Playoffs - Round 3 - Home Game B,C,24590,1460,-23130,34:56.5,3
6/23/2021,20PNR3GB,2021 NBA Playoffs - Round 3 - Home Game B,D,0,14190,14190,33:09.3,1
6/23/2021,20PNR3GB,2021 NBA Playoffs - Round 3 - Home Game B,D,14190,23530,9340,17:05.5,2
6/23/2021,20PNR3GB,2021 NBA Playoffs - Round 3 - Home Game B,D,23530,1395,-22135,34:56.5,3
6/23/2021,20PNR3GB,2021 NBA Playoffs - Round 3 - Home Game B,E,0,13330,13330,33:09.4,1
6/23/2021,20PNR3GB,2021 NBA Playoffs - Round 3 - Home Game B,E,13330,19750,6420,17:05.6,2
6/23/2021,20PNR3GB,2021 NBA Playoffs - Round 3 - Home Game B,E,19750,1170,-18580,34:56.5,3
6/23/2021,20PNR3GB,2021 NBA Playoffs - Round 3 - Home Game B,F,0,11395,11395,33:09.5,1
6/23/2021,20PNR3GB,2021 NBA Playoffs - Round 3 - Home Game B,F,11395,18710,7315,17:05.7,2
6/23/2021,20PNR3GB,2021 NBA Playoffs - Round 3 - Home Game B,F,18710,1110,-17600,34:56.5,3
6/23/2021,20PNR3GB,2021 NBA Playoffs - Round 3 - Home Game B,G,0,10965,10965,33:09.6,1
6/23/2021,20PNR3GB,2021 NBA Playoffs - Round 3 - Home Game B,G,10965,17090,6125,17:05.8,2
6/23/2021,20PNR3GB,2021 NBA Playoffs - Round 3 - Home Game B,G,17090,1015,-16075,34:56.5,3
6/23/2021,20PNR3GB,2021 NBA Playoffs - Round 3 - Home Game B,H,0,10535,10535,33:09.7,1
6/23/2021,20PNR3GB,2021 NBA Playoffs - Round 3 - Home Game B,H,10535,15770,5235,17:05.9,2
6/23/2021,20PNR3GB,2021 NBA Playoffs - Round 3 - Home Game B,H,15770,935,-14835,34:56.5,3
6/23/2021,20PNR3GB,2021 NBA Playoffs - Round 3 - Home Game B,I,0,9030,9030,33:09.8,1
6/23/2021,20PNR3GB,2021 NBA Playoffs - Round 3 - Home Game B,I,9030,14180,5150,17:06.0,2
6/23/2021,20PNR3GB,2021 NBA Playoffs - Round 3 - Home Game B,I,14180,840,-13340,34:56.5,3
6/23/2021,20PNR3GB,2021 NBA Playoffs - Round 3 - Home Game B,J,0,8385,8385,33:09.9,1
6/23/2021,20PNR3GB,2021 NBA Playoffs - Round 3 - Home Game B,J,8385,13080,4695,17:06.0,2
6/23/2021,20PNR3GB,2021 NBA Playoffs - Round 3 - Home Game B,J,13080,775,-12305,34:56.5,3
6/23/2021,20PNR3GB,2021 NBA Playoffs - Round 3 - Home Game B,K,0,6880,6880,33:10.0,1
6/23/2021,20PNR3GB,2021 NBA Playoffs - Round 3 - Home Game B,K,6880,12160,5280,17:06.1,2
6/23/2021,20PNR3GB,2021 NBA Playoffs - Round 3 - Home Game B,K,12160,720,-11440,34:56.5,3
6/23/2021,20PNR3GB,2021 NBA Playoffs - Round 3 - Home Game B,L,0,6450,6450,33:10.1,1
6/23/2021,20PNR3GB,2021 NBA Playoffs - Round 3 - Home Game B,L,6450,11930,5480,17:06.2,2
6/23/2021,20PNR3GB,2021 NBA Playoffs - Round 3 - Home Game B,L,11930,705,-11225,34:56.5,3
6/23/2021,20PNR3GB,2021 NBA Playoffs - Round 3 - Home Game B,M,0,6020,6020,33:10.2,1
6/23/2021,20PNR3GB,2021 NBA Playoffs - Round 3 - Home Game B,M,6020,10470,4450,17:06.3,2
6/23/2021,20PNR3GB,2021 NBA Playoffs - Round 3 - Home Game B,M,10470,620,-9850,34:56.5,3
6/23/2021,20PNR3GB,2021 NBA Playoffs - Round 3 - Home Game B,N,0,10105,10105,33:10.3,1
6/23/2021,20PNR3GB,2021 NBA Playoffs - Round 3 - Home Game B,N,10105,17290,7185,17:06.4,2
6/23/2021,20PNR3GB,2021 NBA Playoffs - Round 3 - Home Game B,N,17290,1025,-16265,34:56.5,3
6/23/2021,20PNR3GB,2021 NBA Playoffs - Round 3 - Home Game B,O,0,9460,9460,33:10.4,1
6/23/2021,20PNR3GB,2021 NBA Playoffs - Round 3 - Home Game B,O,9460,15550,6090,17:06.5,2
6/23/2021,20PNR3GB,2021 NBA Playoffs - Round 3 - Home Game B,O,15550,920,-14630,34:56.5,3
6/23/2021,20PNR3GB,2021 NBA Playoffs - Round 3 - Home Game B,P,0,7740,7740,33:10.5,1
6/23/2021,20PNR3GB,2021 NBA Playoffs - Round 3 - Home Game B,P,7740,13670,5930,17:06.6,2
6/23/2021,20PNR3GB,2021 NBA Playoffs - Round 3 - Home Game B,P,13670,810,-12860,34:56.5,3
6/23/2021,20PNR3GB,2021 NBA Playoffs - Round 3 - Home Game B,Q,0,6880,6880,33:10.6,1
6/23/2021,20PNR3GB,2021 NBA Playoffs - Round 3 - Home Game B,Q,6880,10960,4080,17:06.7,2
6/23/2021,20PNR3GB,2021 NBA Playoffs - Round 3 - Home Game B,Q,10960,650,-10310,34:56.5,3
6/23/2021,20PNR3GB,2021 NBA Playoffs - Round 3 - Home Game B,R,0,5590,5590,33:10.8,1
6/23/2021,20PNR3GB,2021 NBA Playoffs - Round 3 - Home Game B,R,5590,9740,4150,17:06.7,2
6/23/2021,20PNR3GB,2021 NBA Playoffs - Round 3 - Home Game B,R,9740,580,-9160,34:56.5,3
6/23/2021,20PNR3GB,2021 NBA Playoffs - Round 3 - Home Game B,S,0,5590,5590,33:10.9,1
6/23/2021,20PNR3GB,2021 NBA Playoffs - Round 3 - Home Game B,S,5590,9740,4150,17:06.8,2
6/23/2021,20PNR3GB,2021 NBA Playoffs - Round 3 - Home Game B,S,9740,580,-9160,34:56.5,3
6/23/2021,20PNR3GB,2021 NBA Playoffs - Round 3 - Home Game B,T,0,4730,4730,33:11.0,1
6/23/2021,20PNR3GB,2021 NBA Playoffs - Round 3 - Home Game B,T,4730,8030,3300,17:06.9,2
6/23/2021,20PNR3GB,2021 NBA Playoffs - Round 3 - Home Game B,T,8030,475,-7555,34:56.5,3
6/23/2021,20PNR3GB,2021 NBA Playoffs - Round 3 - Home Game B,U,0,3870,3870,33:11.1,1
6/23/2021,20PNR3GB,2021 NBA Playoffs - Round 3 - Home Game B,U,3870,7130,3260,17:07.0,2
6/23/2021,20PNR3GB,2021 NBA Playoffs - Round 3 - Home Game B,U,7130,425,-6705,34:56.5,3
6/23/2021,20PNR3GB,2021 NBA Playoffs - Round 3 - Home Game B,V,0,3440,3440,33:11.1,1
6/23/2021,20PNR3GB,2021 NBA Playoffs - Round 3 - Home Game B,V,3440,6430,2990,17:07.1,2
6/23/2021,20PNR3GB,2021 NBA Playoffs - Round 3 - Home Game B,V,6430,380,-6050,34:56.5,3
6/23/2021,20PNR3GB,2021 NBA Playoffs - Round 3 - Home Game B,W,0,3010,3010,33:11.3,1
6/23/2021,20PNR3GB,2021 NBA Playoffs - Round 3 - Home Game B,W,3010,6030,3020,17:07.2,2
6/23/2021,20PNR3GB,2021 NBA Playoffs - Round 3 - Home Game B,W,6030,360,-5670,34:56.5,3
6/23/2021,20PNR3GB,2021 NBA Playoffs - Round 3 - Home Game B,X,0,2795,2795,33:11.4,1
6/23/2021,20PNR3GB,2021 NBA Playoffs - Round 3 - Home Game B,X,2795,5370,2575,17:07.3,2
6/23/2021,20PNR3GB,2021 NBA Playoffs - Round 3 - Home Game B,X,5370,320,-5050,34:56.5,3
6/23/2021,20PNR3GB,2021 NBA Playoffs - Round 3 - Home Game B,Y,0,2795,2795,33:11.5,1
6/23/2021,20PNR3GB,2021 NBA Playoffs - Round 3 - Home Game B,Y,2795,5220,2425,17:07.3,2
6/23/2021,20PNR3GB,2021 NBA Playoffs - Round 3 - Home Game B,Y,5220,310,-4910,34:56.5,3
6/23/2021,20PNR3GB,2021 NBA Playoffs - Round 3 - Home Game B,Z,0,999999,999999,33:11.6,1
6/23/2021,20PNR3GB,2021 NBA Playoffs - Round 3 - Home Game B,Z,999999,20190,-979809,17:07.4,2
6/23/2021,20PNR3GB,2021 NBA Playoffs - Round 3 - Home Game B,Z,20190,1195,-18995,34:56.5,3
6/23/2021,20PNR3VB,2021 NBA Playoffs - Round 3 - Home Game B,1,0,10285,10285,32:07.5,1
6/23/2021,20PNR3VB,2021 NBA Playoffs - Round 3 - Home Game B,2,0,10285,10285,32:07.6,1
6/23/2021,20PNR3VB,2021 NBA Playoffs - Round 3 - Home Game B,3,0,10285,10285,32:07.7,1
6/23/2021,20PNR3VB,2021 NBA Playoffs - Round 3 - Home Game B,4,0,7480,7480,32:07.9,1
6/23/2021,20PNR3VB,2021 NBA Playoffs - Round 3 - Home Game B,5,0,3770,3770,32:07.9,1
6/23/2021,20PNR3VB,2021 NBA Playoffs - Round 3 - Home Game B,6,0,2825,2825,32:08.1,1
6/23/2021,20PNR3VB,2021 NBA Playoffs - Round 3 - Home Game B,A,0,1755,1755,32:08.2,1
6/23/2021,20PNR3VB,2021 NBA Playoffs - Round 3 - Home Game B,B,0,1595,1595,32:08.3,1
6/23/2021,20PNR3VB,2021 NBA Playoffs - Round 3 - Home Game B,C,0,1460,1460,32:08.4,1
6/23/2021,20PNR3VB,2021 NBA Playoffs - Round 3 - Home Game B,D,0,1395,1395,32:08.5,1
6/23/2021,20PNR3VB,2021 NBA Playoffs - Round 3 - Home Game B,E,0,1170,1170,32:08.6,1
6/23/2021,20PNR3VB,2021 NBA Playoffs - Round 3 - Home Game B,F,0,1110,1110,32:08.7,1
6/23/2021,20PNR3VB,2021 NBA Playoffs - Round 3 - Home Game B,G,0,1015,1015,32:08.8,1
6/23/2021,20PNR3VB,2021 NBA Playoffs - Round 3 - Home Game B,H,0,935,935,32:08.9,1
6/23/2021,20PNR3VB,2021 NBA Playoffs - Round 3 - Home Game B,I,0,840,840,32:09.0,1
6/23/2021,20PNR3VB,2021 NBA Playoffs - Round 3 - Home Game B,J,0,775,775,32:09.1,1
6/23/2021,20PNR3VB,2021 NBA Playoffs - Round 3 - Home Game B,K,0,720,720,32:09.2,1
6/23/2021,20PNR3VB,2021 NBA Playoffs - Round 3 - Home Game B,L,0,705,705,32:09.3,1
6/23/2021,20PNR3VB,2021 NBA Playoffs - Round 3 - Home Game B,M,0,620,620,32:09.5,1
6/23/2021,20PNR3VB,2021 NBA Playoffs - Round 3 - Home Game B,N,0,1025,1025,32:09.6,1
6/23/2021,20PNR3VB,2021 NBA Playoffs - Round 3 - Home Game B,O,0,920,920,32:09.7,1
6/23/2021,20PNR3VB,2021 NBA Playoffs - Round 3 - Home Game B,P,0,810,810,32:09.8,1
6/23/2021,20PNR3VB,2021 NBA Playoffs - Round 3 - Home Game B,Q,0,650,650,32:09.9,1
6/23/2021,20PNR3VB,2021 NBA Playoffs - Round 3 - Home Game B,R,0,580,580,32:10.0,1
6/23/2021,20PNR3VB,2021 NBA Playoffs - Round 3 - Home Game B,S,0,580,580,32:10.1,1
6/23/2021,20PNR3VB,2021 NBA Playoffs - Round 3 - Home Game B,T,0,475,475,32:10.3,1
6/23/2021,20PNR3VB,2021 NBA Playoffs - Round 3 - Home Game B,U,0,425,425,32:10.4,1
6/23/2021,20PNR3VB,2021 NBA Playoffs - Round 3 - Home Game B,V,0,380,380,32:10.5,1
6/23/2021,20PNR3VB,2021 NBA Playoffs - Round 3 - Home Game B,W,0,360,360,32:10.7,1
6/23/2021,20PNR3VB,2021 NBA Playoffs - Round 3 - Home Game B,X,0,320,320,32:10.8,1
6/23/2021,20PNR3VB,2021 NBA Playoffs - Round 3 - Home Game B,Y,0,310,310,32:11.0,1
6/23/2021,20PNR3VB,2021 NBA Playoffs - Round 3 - Home Game B,Z,0,1195,1195,32:11.1,1
6/26/2021,20PNR3GC,2021 NBA Playoffs - Round 3 - Home Game C,1,0,236500,236500,33:11.7,1
6/26/2021,20PNR3GC,2021 NBA Playoffs - Round 3 - Home Game C,1,236500,157500,-79000,17:07.5,2
6/26/2021,20PNR3GC,2021 NBA Playoffs - Round 3 - Home Game C,1,157500,11635,-145865,34:56.5,3
6/26/2021,20PNR3GC,2021 NBA Playoffs - Round 3 - Home Game C,2,0,98900,98900,33:11.8,1
6/26/2021,20PNR3GC,2021 NBA Playoffs - Round 3 - Home Game C,2,98900,11635,-87265,34:56.5,2
6/26/2021,20PNR3GC,2021 NBA Playoffs - Round 3 - Home Game C,3,0,85979,85979,33:11.9,1
6/26/2021,20PNR3GC,2021 NBA Playoffs - Round 3 - Home Game C,3,85979,157500,71521,17:07.6,2
6/26/2021,20PNR3GC,2021 NBA Playoffs - Round 3 - Home Game C,3,157500,11635,-145865,34:56.5,3
6/26/2021,20PNR3GC,2021 NBA Playoffs - Round 3 - Home Game C,4,0,47300,47300,33:12.0,1
6/26/2021,20PNR3GC,2021 NBA Playoffs - Round 3 - Home Game C,4,47300,114540,67240,17:07.7,2
6/26/2021,20PNR3GC,2021 NBA Playoffs - Round 3 - Home Game C,4,114540,8460,-106080,34:56.5,3
6/26/2021,20PNR3GC,2021 NBA Playoffs - Round 3 - Home Game C,5,0,43000,43000,33:12.1,1
6/26/2021,20PNR3GC,2021 NBA Playoffs - Round 3 - Home Game C,5,43000,59120,16120,17:07.8,2
6/26/2021,20PNR3GC,2021 NBA Playoffs - Round 3 - Home Game C,5,59120,5155,-53965,34:56.5,3
6/26/2021,20PNR3GC,2021 NBA Playoffs - Round 3 - Home Game C,5,5155,4785,-370,54:56.8,4
6/26/2021,20PNR3GC,2021 NBA Playoffs - Round 3 - Home Game C,5,5155,4785,-370,54:56.8,5
6/26/2021,20PNR3GC,2021 NBA Playoffs - Round 3 - Home Game C,6,0,30100,30100,33:12.2,1
6/26/2021,20PNR3GC,2021 NBA Playoffs - Round 3 - Home Game C,6,30100,41100,11000,17:07.9,2
6/26/2021,20PNR3GC,2021 NBA Playoffs - Round 3 - Home Game C,6,41100,3585,-37515,34:56.5,3
6/26/2021,20PNR3GC,2021 NBA Playoffs - Round 3 - Home Game C,7,23650,38610,14960,17:08.0,1
6/26/2021,20PNR3GC,2021 NBA Playoffs - Round 3 - Home Game C,7,38610,3365,-35245,34:56.5,2
6/26/2021,20PNR3GC,2021 NBA Playoffs - Round 3 - Home Game C,7,3365,3490,125,54:56.8,3
6/26/2021,20PNR3GC,2021 NBA Playoffs - Round 3 - Home Game C,7,3365,3490,125,54:56.8,4
6/26/2021,20PNR3GC,2021 NBA Playoffs - Round 3 - Home Game C,8,18275,32420,14145,17:08.1,1
6/26/2021,20PNR3GC,2021 NBA Playoffs - Round 3 - Home Game C,8,32420,2440,-29980,34:56.5,2
6/26/2021,20PNR3GC,2021 NBA Playoffs - Round 3 - Home Game C,9,17630,31260,13630,17:08.2,1
6/26/2021,20PNR3GC,2021 NBA Playoffs - Round 3 - Home Game C,9,31260,2355,-28905,34:56.5,2
6/26/2021,20PNR3GC,2021 NBA Playoffs - Round 3 - Home Game C,A,0,16770,16770,33:12.3,1
6/26/2021,20PNR3GC,2021 NBA Playoffs - Round 3 - Home Game C,A,16770,29570,12800,17:08.3,2
6/26/2021,20PNR3GC,2021 NBA Playoffs - Round 3 - Home Game C,A,29570,2230,-27340,34:56.5,3
6/26/2021,20PNR3GC,2021 NBA Playoffs - Round 3 - Home Game C,B,0,16125,16125,33:12.4,1
6/26/2021,20PNR3GC,2021 NBA Playoffs - Round 3 - Home Game C,B,16125,26880,10755,17:08.4,2
6/26/2021,20PNR3GC,2021 NBA Playoffs - Round 3 - Home Game C,B,26880,2025,-24855,34:56.5,3
6/26/2021,20PNR3GC,2021 NBA Playoffs - Round 3 - Home Game C,C,0,15050,15050,33:12.5,1
6/26/2021,20PNR3GC,2021 NBA Playoffs - Round 3 - Home Game C,C,15050,24590,9540,17:08.5,2
6/26/2021,20PNR3GC,2021 NBA Playoffs - Round 3 - Home Game C,C,24590,1855,-22735,34:56.5,3
6/26/2021,20PNR3GC,2021 NBA Playoffs - Round 3 - Home Game C,D,0,14190,14190,33:12.6,1
6/26/2021,20PNR3GC,2021 NBA Playoffs - Round 3 - Home Game C,D,14190,23530,9340,17:08.5,2
6/26/2021,20PNR3GC,2021 NBA Playoffs - Round 3 - Home Game C,D,23530,1770,-21760,34:56.5,3
6/26/2021,20PNR3GC,2021 NBA Playoffs - Round 3 - Home Game C,E,0,13330,13330,33:12.7,1
6/26/2021,20PNR3GC,2021 NBA Playoffs - Round 3 - Home Game C,E,13330,19750,6420,17:08.7,2
6/26/2021,20PNR3GC,2021 NBA Playoffs - Round 3 - Home Game C,E,19750,1490,-18260,34:56.5,3
6/26/2021,20PNR3GC,2021 NBA Playoffs - Round 3 - Home Game C,F,0,11395,11395,33:12.8,1
6/26/2021,20PNR3GC,2021 NBA Playoffs - Round 3 - Home Game C,F,11395,18710,7315,17:08.7,2
6/26/2021,20PNR3GC,2021 NBA Playoffs - Round 3 - Home Game C,F,18710,1410,-17300,34:56.5,3
6/26/2021,20PNR3GC,2021 NBA Playoffs - Round 3 - Home Game C,G,0,10965,10965,33:12.9,1
6/26/2021,20PNR3GC,2021 NBA Playoffs - Round 3 - Home Game C,G,10965,17090,6125,17:08.8,2
6/26/2021,20PNR3GC,2021 NBA Playoffs - Round 3 - Home Game C,G,17090,1290,-15800,34:56.5,3
6/26/2021,20PNR3GC,2021 NBA Playoffs - Round 3 - Home Game C,H,0,10535,10535,33:13.0,1
6/26/2021,20PNR3GC,2021 NBA Playoffs - Round 3 - Home Game C,H,10535,15770,5235,17:08.9,2
6/26/2021,20PNR3GC,2021 NBA Playoffs - Round 3 - Home Game C,H,15770,1190,-14580,34:56.5,3
6/26/2021,20PNR3GC,2021 NBA Playoffs - Round 3 - Home Game C,I,0,9030,9030,33:13.1,1
6/26/2021,20PNR3GC,2021 NBA Playoffs - Round 3 - Home Game C,I,9030,14180,5150,17:09.0,2
6/26/2021,20PNR3GC,2021 NBA Playoffs - Round 3 - Home Game C,I,14180,1070,-13110,34:56.5,3
6/26/2021,20PNR3GC,2021 NBA Playoffs - Round 3 - Home Game C,J,0,8385,8385,33:13.2,1
6/26/2021,20PNR3GC,2021 NBA Playoffs - Round 3 - Home Game C,J,8385,13080,4695,17:09.1,2
6/26/2021,20PNR3GC,2021 NBA Playoffs - Round 3 - Home Game C,J,13080,985,-12095,34:56.5,3
6/26/2021,20PNR3GC,2021 NBA Playoffs - Round 3 - Home Game C,K,0,6880,6880,33:13.3,1
6/26/2021,20PNR3GC,2021 NBA Playoffs - Round 3 - Home Game C,K,6880,12160,5280,17:09.2,2
6/26/2021,20PNR3GC,2021 NBA Playoffs - Round 3 - Home Game C,K,12160,915,-11245,34:56.5,3
6/26/2021,20PNR3GC,2021 NBA Playoffs - Round 3 - Home Game C,L,0,6450,6450,33:13.4,1
6/26/2021,20PNR3GC,2021 NBA Playoffs - Round 3 - Home Game C,L,6450,11930,5480,17:09.3,2
6/26/2021,20PNR3GC,2021 NBA Playoffs - Round 3 - Home Game C,L,11930,900,-11030,34:56.5,3
6/26/2021,20PNR3GC,2021 NBA Playoffs - Round 3 - Home Game C,M,0,6020,6020,33:13.5,1
6/26/2021,20PNR3GC,2021 NBA Playoffs - Round 3 - Home Game C,M,6020,10470,4450,17:09.4,2
6/26/2021,20PNR3GC,2021 NBA Playoffs - Round 3 - Home Game C,M,10470,790,-9680,34:56.5,3
6/26/2021,20PNR3GC,2021 NBA Playoffs - Round 3 - Home Game C,N,0,10105,10105,33:13.6,1
6/26/2021,20PNR3GC,2021 NBA Playoffs - Round 3 - Home Game C,N,10105,17290,7185,17:09.5,2
6/26/2021,20PNR3GC,2021 NBA Playoffs - Round 3 - Home Game C,N,17290,1305,-15985,34:56.5,3
6/26/2021,20PNR3GC,2021 NBA Playoffs - Round 3 - Home Game C,O,0,9460,9460,33:13.7,1
6/26/2021,20PNR3GC,2021 NBA Playoffs - Round 3 - Home Game C,O,9460,15550,6090,17:09.6,2
6/26/2021,20PNR3GC,2021 NBA Playoffs - Round 3 - Home Game C,O,15550,1170,-14380,34:56.5,3
6/26/2021,20PNR3GC,2021 NBA Playoffs - Round 3 - Home Game C,P,0,7740,7740,33:13.8,1
6/26/2021,20PNR3GC,2021 NBA Playoffs - Round 3 - Home Game C,P,7740,13670,5930,17:09.7,2
6/26/2021,20PNR3GC,2021 NBA Playoffs - Round 3 - Home Game C,P,13670,1030,-12640,34:56.5,3
6/26/2021,20PNR3GC,2021 NBA Playoffs - Round 3 - Home Game C,Q,0,6880,6880,33:13.9,1
6/26/2021,20PNR3GC,2021 NBA Playoffs - Round 3 - Home Game C,Q,6880,10960,4080,17:09.7,2
6/26/2021,20PNR3GC,2021 NBA Playoffs - Round 3 - Home Game C,Q,10960,825,-10135,34:56.5,3
6/26/2021,20PNR3GC,2021 NBA Playoffs - Round 3 - Home Game C,R,0,5590,5590,33:14.0,1
6/26/2021,20PNR3GC,2021 NBA Playoffs - Round 3 - Home Game C,R,5590,9740,4150,17:09.8,2
6/26/2021,20PNR3GC,2021 NBA Playoffs - Round 3 - Home Game C,R,9740,735,-9005,34:56.5,3
6/26/2021,20PNR3GC,2021 NBA Playoffs - Round 3 - Home Game C,S,0,5590,5590,33:14.1,1
6/26/2021,20PNR3GC,2021 NBA Playoffs - Round 3 - Home Game C,S,5590,9740,4150,17:09.9,2
6/26/2021,20PNR3GC,2021 NBA Playoffs - Round 3 - Home Game C,S,9740,735,-9005,34:56.5,3
6/26/2021,20PNR3GC,2021 NBA Playoffs - Round 3 - Home Game C,T,0,4730,4730,33:14.2,1
6/26/2021,20PNR3GC,2021 NBA Playoffs - Round 3 - Home Game C,T,4730,8030,3300,17:10.0,2
6/26/2021,20PNR3GC,2021 NBA Playoffs - Round 3 - Home Game C,T,8030,605,-7425,34:56.5,3
6/26/2021,20PNR3GC,2021 NBA Playoffs - Round 3 - Home Game C,U,0,3870,3870,33:14.3,1
6/26/2021,20PNR3GC,2021 NBA Playoffs - Round 3 - Home Game C,U,3870,7130,3260,17:10.1,2
6/26/2021,20PNR3GC,2021 NBA Playoffs - Round 3 - Home Game C,U,7130,535,-6595,34:56.5,3
6/26/2021,20PNR3GC,2021 NBA Playoffs - Round 3 - Home Game C,V,0,3440,3440,33:14.4,1
6/26/2021,20PNR3GC,2021 NBA Playoffs - Round 3 - Home Game C,V,3440,6430,2990,17:10.2,2
6/26/2021,20PNR3GC,2021 NBA Playoffs - Round 3 - Home Game C,V,6430,485,-5945,34:56.5,3
6/26/2021,20PNR3GC,2021 NBA Playoffs - Round 3 - Home Game C,W,0,3010,3010,33:14.5,1
6/26/2021,20PNR3GC,2021 NBA Playoffs - Round 3 - Home Game C,W,3010,6030,3020,17:10.3,2
6/26/2021,20PNR3GC,2021 NBA Playoffs - Round 3 - Home Game C,W,6030,455,-5575,34:56.5,3
6/26/2021,20PNR3GC,2021 NBA Playoffs - Round 3 - Home Game C,X,0,2795,2795,33:14.6,1
6/26/2021,20PNR3GC,2021 NBA Playoffs - Round 3 - Home Game C,X,2795,5370,2575,17:10.4,2
6/26/2021,20PNR3GC,2021 NBA Playoffs - Round 3 - Home Game C,X,5370,405,-4965,34:56.5,3
6/26/2021,20PNR3GC,2021 NBA Playoffs - Round 3 - Home Game C,Y,0,2795,2795,33:14.7,1
6/26/2021,20PNR3GC,2021 NBA Playoffs - Round 3 - Home Game C,Y,2795,5220,2425,17:10.5,2
6/26/2021,20PNR3GC,2021 NBA Playoffs - Round 3 - Home Game C,Y,5220,395,-4825,34:56.5,3
6/26/2021,20PNR3GC,2021 NBA Playoffs - Round 3 - Home Game C,Z,0,999999,999999,33:14.8,1
6/26/2021,20PNR3GC,2021 NBA Playoffs - Round 3 - Home Game C,Z,999999,20190,-979809,17:10.6,2
6/26/2021,20PNR3GC,2021 NBA Playoffs - Round 3 - Home Game C,Z,20190,1520,-18670,34:56.5,3
6/26/2021,20PNR3VC,2021 NBA Playoffs - Round 3 - Home Game C,1,0,11635,11635,32:58.5,1
6/26/2021,20PNR3VC,2021 NBA Playoffs - Round 3 - Home Game C,2,0,11635,11635,32:58.7,1
6/26/2021,20PNR3VC,2021 NBA Playoffs - Round 3 - Home Game C,3,0,11635,11635,32:58.8,1
6/26/2021,20PNR3VC,2021 NBA Playoffs - Round 3 - Home Game C,4,0,8460,8460,32:58.9,1
6/26/2021,20PNR3VC,2021 NBA Playoffs - Round 3 - Home Game C,5,0,4785,4785,32:59.0,1
6/26/2021,20PNR3VC,2021 NBA Playoffs - Round 3 - Home Game C,6,0,3585,3585,32:59.1,1
6/26/2021,20PNR3VC,2021 NBA Playoffs - Round 3 - Home Game C,A,0,2230,2230,32:59.2,1
6/26/2021,20PNR3VC,2021 NBA Playoffs - Round 3 - Home Game C,B,0,2025,2025,32:59.3,1
6/26/2021,20PNR3VC,2021 NBA Playoffs - Round 3 - Home Game C,C,0,1855,1855,32:59.4,1
6/26/2021,20PNR3VC,2021 NBA Playoffs - Round 3 - Home Game C,D,0,1770,1770,32:59.5,1
6/26/2021,20PNR3VC,2021 NBA Playoffs - Round 3 - Home Game C,E,0,1490,1490,32:59.6,1
6/26/2021,20PNR3VC,2021 NBA Playoffs - Round 3 - Home Game C,F,0,1410,1410,32:59.7,1
6/26/2021,20PNR3VC,2021 NBA Playoffs - Round 3 - Home Game C,G,0,1290,1290,32:59.8,1
6/26/2021,20PNR3VC,2021 NBA Playoffs - Round 3 - Home Game C,H,0,1190,1190,32:59.9,1
6/26/2021,20PNR3VC,2021 NBA Playoffs - Round 3 - Home Game C,I,0,1070,1070,33:00.1,1
6/26/2021,20PNR3VC,2021 NBA Playoffs - Round 3 - Home Game C,J,0,985,985,33:00.2,1
6/26/2021,20PNR3VC,2021 NBA Playoffs - Round 3 - Home Game C,K,0,915,915,33:00.4,1
6/26/2021,20PNR3VC,2021 NBA Playoffs - Round 3 - Home Game C,L,0,900,900,33:00.5,1
6/26/2021,20PNR3VC,2021 NBA Playoffs - Round 3 - Home Game C,M,0,790,790,33:00.6,1
6/26/2021,20PNR3VC,2021 NBA Playoffs - Round 3 - Home Game C,N,0,1305,1305,33:00.7,1
6/26/2021,20PNR3VC,2021 NBA Playoffs - Round 3 - Home Game C,O,0,1170,1170,33:00.8,1
6/26/2021,20PNR3VC,2021 NBA Playoffs - Round 3 - Home Game C,P,0,1030,1030,33:00.9,1
6/26/2021,20PNR3VC,2021 NBA Playoffs - Round 3 - Home Game C,Q,0,825,825,33:01.0,1
6/26/2021,20PNR3VC,2021 NBA Playoffs - Round 3 - Home Game C,R,0,735,735,33:01.1,1
6/26/2021,20PNR3VC,2021 NBA Playoffs - Round 3 - Home Game C,S,0,735,735,33:01.2,1
6/26/2021,20PNR3VC,2021 NBA Playoffs - Round 3 - Home Game C,T,0,605,605,33:01.3,1
6/26/2021,20PNR3VC,2021 NBA Playoffs - Round 3 - Home Game C,U,0,535,535,33:01.4,1
6/26/2021,20PNR3VC,2021 NBA Playoffs - Round 3 - Home Game C,V,0,485,485,33:01.5,1
6/26/2021,20PNR3VC,2021 NBA Playoffs - Round 3 - Home Game C,W,0,455,455,33:01.7,1
6/26/2021,20PNR3VC,2021 NBA Playoffs - Round 3 - Home Game C,X,0,405,405,33:01.7,1
6/26/2021,20PNR3VC,2021 NBA Playoffs - Round 3 - Home Game C,Y,0,395,395,33:01.9,1
6/26/2021,20PNR3VC,2021 NBA Playoffs - Round 3 - Home Game C,Z,0,1520,1520,33:02.0,1
6/29/2021,20PNR3GD,2021 NBA Playoffs - Round 3 - Home Game D,1,0,236500,236500,33:14.9,1
6/29/2021,20PNR3GD,2021 NBA Playoffs - Round 3 - Home Game D,1,236500,157500,-79000,17:10.7,2
6/29/2021,20PNR3GD,2021 NBA Playoffs - Round 3 - Home Game D,1,157500,11635,-145865,34:56.5,3
6/29/2021,20PNR3GD,2021 NBA Playoffs - Round 3 - Home Game D,2,0,98900,98900,33:15.1,1
6/29/2021,20PNR3GD,2021 NBA Playoffs - Round 3 - Home Game D,2,98900,11635,-87265,34:56.5,2
6/29/2021,20PNR3GD,2021 NBA Playoffs - Round 3 - Home Game D,3,0,85979,85979,33:15.1,1
6/29/2021,20PNR3GD,2021 NBA Playoffs - Round 3 - Home Game D,3,85979,157500,71521,17:10.8,2
6/29/2021,20PNR3GD,2021 NBA Playoffs - Round 3 - Home Game D,3,157500,11635,-145865,34:56.5,3
6/29/2021,20PNR3GD,2021 NBA Playoffs - Round 3 - Home Game D,4,0,47300,47300,33:15.2,1
6/29/2021,20PNR3GD,2021 NBA Playoffs - Round 3 - Home Game D,4,47300,114540,67240,17:10.9,2
6/29/2021,20PNR3GD,2021 NBA Playoffs - Round 3 - Home Game D,4,114540,8460,-106080,34:56.5,3
6/29/2021,20PNR3GD,2021 NBA Playoffs - Round 3 - Home Game D,5,0,43000,43000,33:15.3,1
6/29/2021,20PNR3GD,2021 NBA Playoffs - Round 3 - Home Game D,5,43000,59120,16120,17:11.0,2
6/29/2021,20PNR3GD,2021 NBA Playoffs - Round 3 - Home Game D,5,59120,5155,-53965,34:56.5,3
6/29/2021,20PNR3GD,2021 NBA Playoffs - Round 3 - Home Game D,5,5155,4785,-370,54:56.8,4
6/29/2021,20PNR3GD,2021 NBA Playoffs - Round 3 - Home Game D,5,5155,4785,-370,54:56.8,5
6/29/2021,20PNR3GD,2021 NBA Playoffs - Round 3 - Home Game D,6,0,30100,30100,33:15.5,1
6/29/2021,20PNR3GD,2021 NBA Playoffs - Round 3 - Home Game D,6,30100,41100,11000,17:11.0,2
6/29/2021,20PNR3GD,2021 NBA Playoffs - Round 3 - Home Game D,6,41100,3585,-37515,34:56.5,3
6/29/2021,20PNR3GD,2021 NBA Playoffs - Round 3 - Home Game D,7,23650,38610,14960,17:11.1,1
6/29/2021,20PNR3GD,2021 NBA Playoffs - Round 3 - Home Game D,7,38610,3365,-35245,34:56.5,2
6/29/2021,20PNR3GD,2021 NBA Playoffs - Round 3 - Home Game D,7,3365,3490,125,54:56.8,3
6/29/2021,20PNR3GD,2021 NBA Playoffs - Round 3 - Home Game D,7,3365,3490,125,54:56.8,4
6/29/2021,20PNR3GD,2021 NBA Playoffs - Round 3 - Home Game D,8,18275,32420,14145,17:11.2,1
6/29/2021,20PNR3GD,2021 NBA Playoffs - Round 3 - Home Game D,8,32420,2440,-29980,34:56.5,2
6/29/2021,20PNR3GD,2021 NBA Playoffs - Round 3 - Home Game D,9,17630,31260,13630,17:11.3,1
6/29/2021,20PNR3GD,2021 NBA Playoffs - Round 3 - Home Game D,9,31260,2355,-28905,34:56.5,2
6/29/2021,20PNR3GD,2021 NBA Playoffs - Round 3 - Home Game D,A,0,16770,16770,33:15.5,1
6/29/2021,20PNR3GD,2021 NBA Playoffs - Round 3 - Home Game D,A,16770,29570,12800,17:11.4,2
6/29/2021,20PNR3GD,2021 NBA Playoffs - Round 3 - Home Game D,A,29570,2230,-27340,34:56.5,3
6/29/2021,20PNR3GD,2021 NBA Playoffs - Round 3 - Home Game D,B,0,16125,16125,33:15.6,1
6/29/2021,20PNR3GD,2021 NBA Playoffs - Round 3 - Home Game D,B,16125,26880,10755,17:11.5,2
6/29/2021,20PNR3GD,2021 NBA Playoffs - Round 3 - Home Game D,B,26880,2025,-24855,34:56.5,3
6/29/2021,20PNR3GD,2021 NBA Playoffs - Round 3 - Home Game D,C,0,15050,15050,33:15.7,1
6/29/2021,20PNR3GD,2021 NBA Playoffs - Round 3 - Home Game D,C,15050,24590,9540,17:11.6,2
6/29/2021,20PNR3GD,2021 NBA Playoffs - Round 3 - Home Game D,C,24590,1855,-22735,34:56.5,3
6/29/2021,20PNR3GD,2021 NBA Playoffs - Round 3 - Home Game D,D,0,14190,14190,33:15.8,1
6/29/2021,20PNR3GD,2021 NBA Playoffs - Round 3 - Home Game D,D,14190,23530,9340,17:11.7,2
6/29/2021,20PNR3GD,2021 NBA Playoffs - Round 3 - Home Game D,D,23530,1770,-21760,34:56.5,3
6/29/2021,20PNR3GD,2021 NBA Playoffs - Round 3 - Home Game D,E,0,13330,13330,33:15.9,1
6/29/2021,20PNR3GD,2021 NBA Playoffs - Round 3 - Home Game D,E,13330,19750,6420,17:11.8,2
6/29/2021,20PNR3GD,2021 NBA Playoffs - Round 3 - Home Game D,E,19750,1490,-18260,34:56.5,3
6/29/2021,20PNR3GD,2021 NBA Playoffs - Round 3 - Home Game D,F,0,11395,11395,33:16.0,1
6/29/2021,20PNR3GD,2021 NBA Playoffs - Round 3 - Home Game D,F,11395,18710,7315,17:11.9,2
6/29/2021,20PNR3GD,2021 NBA Playoffs - Round 3 - Home Game D,F,18710,1410,-17300,34:56.5,3
6/29/2021,20PNR3GD,2021 NBA Playoffs - Round 3 - Home Game D,G,0,10965,10965,33:16.1,1
6/29/2021,20PNR3GD,2021 NBA Playoffs - Round 3 - Home Game D,G,10965,17090,6125,17:12.0,2
6/29/2021,20PNR3GD,2021 NBA Playoffs - Round 3 - Home Game D,G,17090,1290,-15800,34:56.5,3
6/29/2021,20PNR3GD,2021 NBA Playoffs - Round 3 - Home Game D,H,0,10535,10535,33:16.2,1
6/29/2021,20PNR3GD,2021 NBA Playoffs - Round 3 - Home Game D,H,10535,15770,5235,17:12.1,2
6/29/2021,20PNR3GD,2021 NBA Playoffs - Round 3 - Home Game D,H,15770,1190,-14580,34:56.5,3
6/29/2021,20PNR3GD,2021 NBA Playoffs - Round 3 - Home Game D,I,0,9030,9030,33:16.3,1
6/29/2021,20PNR3GD,2021 NBA Playoffs - Round 3 - Home Game D,I,9030,14180,5150,17:12.2,2
6/29/2021,20PNR3GD,2021 NBA Playoffs - Round 3 - Home Game D,I,14180,1070,-13110,34:56.5,3
6/29/2021,20PNR3GD,2021 NBA Playoffs - Round 3 - Home Game D,J,0,8385,8385,33:16.4,1
6/29/2021,20PNR3GD,2021 NBA Playoffs - Round 3 - Home Game D,J,8385,13080,4695,17:12.3,2
6/29/2021,20PNR3GD,2021 NBA Playoffs - Round 3 - Home Game D,J,13080,985,-12095,34:56.5,3
6/29/2021,20PNR3GD,2021 NBA Playoffs - Round 3 - Home Game D,K,0,6880,6880,33:16.6,1
6/29/2021,20PNR3GD,2021 NBA Playoffs - Round 3 - Home Game D,K,6880,12160,5280,17:12.4,2
6/29/2021,20PNR3GD,2021 NBA Playoffs - Round 3 - Home Game D,K,12160,915,-11245,34:56.5,3
6/29/2021,20PNR3GD,2021 NBA Playoffs - Round 3 - Home Game D,L,0,6450,6450,33:16.7,1
6/29/2021,20PNR3GD,2021 NBA Playoffs - Round 3 - Home Game D,L,6450,11930,5480,17:12.5,2
6/29/2021,20PNR3GD,2021 NBA Playoffs - Round 3 - Home Game D,L,11930,900,-11030,34:56.5,3
6/29/2021,20PNR3GD,2021 NBA Playoffs - Round 3 - Home Game D,M,0,6020,6020,33:16.8,1
6/29/2021,20PNR3GD,2021 NBA Playoffs - Round 3 - Home Game D,M,6020,10470,4450,17:12.6,2
6/29/2021,20PNR3GD,2021 NBA Playoffs - Round 3 - Home Game D,M,10470,790,-9680,34:56.5,3
6/29/2021,20PNR3GD,2021 NBA Playoffs - Round 3 - Home Game D,N,0,10105,10105,33:16.9,1
6/29/2021,20PNR3GD,2021 NBA Playoffs - Round 3 - Home Game D,N,10105,17290,7185,17:12.7,2
6/29/2021,20PNR3GD,2021 NBA Playoffs - Round 3 - Home Game D,N,17290,1305,-15985,34:56.5,3
6/29/2021,20PNR3GD,2021 NBA Playoffs - Round 3 - Home Game D,O,0,9460,9460,33:16.9,1
6/29/2021,20PNR3GD,2021 NBA Playoffs - Round 3 - Home Game D,O,9460,15550,6090,17:12.7,2
6/29/2021,20PNR3GD,2021 NBA Playoffs - Round 3 - Home Game D,O,15550,1170,-14380,34:56.5,3
6/29/2021,20PNR3GD,2021 NBA Playoffs - Round 3 - Home Game D,P,0,7740,7740,33:17.0,1
6/29/2021,20PNR3GD,2021 NBA Playoffs - Round 3 - Home Game D,P,7740,13670,5930,17:12.8,2
6/29/2021,20PNR3GD,2021 NBA Playoffs - Round 3 - Home Game D,P,13670,1030,-12640,34:56.5,3
6/29/2021,20PNR3GD,2021 NBA Playoffs - Round 3 - Home Game D,Q,0,6880,6880,33:17.1,1
6/29/2021,20PNR3GD,2021 NBA Playoffs - Round 3 - Home Game D,Q,6880,10960,4080,17:12.9,2
6/29/2021,20PNR3GD,2021 NBA Playoffs - Round 3 - Home Game D,Q,10960,825,-10135,34:56.5,3
6/29/2021,20PNR3GD,2021 NBA Playoffs - Round 3 - Home Game D,R,0,5590,5590,33:17.2,1
6/29/2021,20PNR3GD,2021 NBA Playoffs - Round 3 - Home Game D,R,5590,9740,4150,17:13.0,2
6/29/2021,20PNR3GD,2021 NBA Playoffs - Round 3 - Home Game D,R,9740,735,-9005,34:56.5,3
6/29/2021,20PNR3GD,2021 NBA Playoffs - Round 3 - Home Game D,S,0,5590,5590,33:17.3,1
6/29/2021,20PNR3GD,2021 NBA Playoffs - Round 3 - Home Game D,S,5590,9740,4150,17:13.1,2
6/29/2021,20PNR3GD,2021 NBA Playoffs - Round 3 - Home Game D,S,9740,735,-9005,34:56.5,3
6/29/2021,20PNR3GD,2021 NBA Playoffs - Round 3 - Home Game D,T,0,4730,4730,33:17.4,1
6/29/2021,20PNR3GD,2021 NBA Playoffs - Round 3 - Home Game D,T,4730,8030,3300,17:13.2,2
6/29/2021,20PNR3GD,2021 NBA Playoffs - Round 3 - Home Game D,T,8030,605,-7425,34:56.5,3
6/29/2021,20PNR3GD,2021 NBA Playoffs - Round 3 - Home Game D,U,0,3870,3870,33:17.5,1
6/29/2021,20PNR3GD,2021 NBA Playoffs - Round 3 - Home Game D,U,3870,7130,3260,17:13.2,2
6/29/2021,20PNR3GD,2021 NBA Playoffs - Round 3 - Home Game D,U,7130,535,-6595,34:56.5,3
6/29/2021,20PNR3GD,2021 NBA Playoffs - Round 3 - Home Game D,V,0,3440,3440,33:17.6,1
6/29/2021,20PNR3GD,2021 NBA Playoffs - Round 3 - Home Game D,V,3440,6430,2990,17:13.3,2
6/29/2021,20PNR3GD,2021 NBA Playoffs - Round 3 - Home Game D,V,6430,485,-5945,34:56.5,3
6/29/2021,20PNR3GD,2021 NBA Playoffs - Round 3 - Home Game D,W,0,3010,3010,33:17.7,1
6/29/2021,20PNR3GD,2021 NBA Playoffs - Round 3 - Home Game D,W,3010,6030,3020,17:13.4,2
6/29/2021,20PNR3GD,2021 NBA Playoffs - Round 3 - Home Game D,W,6030,455,-5575,34:56.5,3
6/29/2021,20PNR3GD,2021 NBA Playoffs - Round 3 - Home Game D,X,0,2795,2795,33:17.8,1
6/29/2021,20PNR3GD,2021 NBA Playoffs - Round 3 - Home Game D,X,2795,5370,2575,17:13.5,2
6/29/2021,20PNR3GD,2021 NBA Playoffs - Round 3 - Home Game D,X,5370,405,-4965,34:56.5,3
6/29/2021,20PNR3GD,2021 NBA Playoffs - Round 3 - Home Game D,Y,0,2795,2795,33:17.9,1
6/29/2021,20PNR3GD,2021 NBA Playoffs - Round 3 - Home Game D,Y,2795,5220,2425,17:13.6,2
6/29/2021,20PNR3GD,2021 NBA Playoffs - Round 3 - Home Game D,Y,5220,395,-4825,34:56.5,3
6/29/2021,20PNR3GD,2021 NBA Playoffs - Round 3 - Home Game D,Z,0,999999,999999,33:18.0,1
6/29/2021,20PNR3GD,2021 NBA Playoffs - Round 3 - Home Game D,Z,999999,20190,-979809,17:13.7,2
6/29/2021,20PNR3GD,2021 NBA Playoffs - Round 3 - Home Game D,Z,20190,1520,-18670,34:56.5,3
6/29/2021,20PNR3VD,2021 NBA Playoffs - Round 3 - Home Game D,1,0,11635,11635,34:38.9,1
6/29/2021,20PNR3VD,2021 NBA Playoffs - Round 3 - Home Game D,2,0,11635,11635,34:39.0,1
6/29/2021,20PNR3VD,2021 NBA Playoffs - Round 3 - Home Game D,3,0,11635,11635,34:39.1,1
6/29/2021,20PNR3VD,2021 NBA Playoffs - Round 3 - Home Game D,4,0,8460,8460,34:39.2,1
6/29/2021,20PNR3VD,2021 NBA Playoffs - Round 3 - Home Game D,5,0,4785,4785,34:39.3,1
6/29/2021,20PNR3VD,2021 NBA Playoffs - Round 3 - Home Game D,6,0,3585,3585,34:39.4,1
6/29/2021,20PNR3VD,2021 NBA Playoffs - Round 3 - Home Game D,A,0,2230,2230,34:39.5,1
6/29/2021,20PNR3VD,2021 NBA Playoffs - Round 3 - Home Game D,B,0,2025,2025,34:39.6,1
6/29/2021,20PNR3VD,2021 NBA Playoffs - Round 3 - Home Game D,C,0,1855,1855,34:39.7,1
6/29/2021,20PNR3VD,2021 NBA Playoffs - Round 3 - Home Game D,D,0,1770,1770,34:39.8,1
6/29/2021,20PNR3VD,2021 NBA Playoffs - Round 3 - Home Game D,E,0,1490,1490,34:39.9,1
6/29/2021,20PNR3VD,2021 NBA Playoffs - Round 3 - Home Game D,F,0,1410,1410,34:40.0,1
6/29/2021,20PNR3VD,2021 NBA Playoffs - Round 3 - Home Game D,G,0,1290,1290,34:40.2,1
6/29/2021,20PNR3VD,2021 NBA Playoffs - Round 3 - Home Game D,H,0,1190,1190,34:40.3,1
6/29/2021,20PNR3VD,2021 NBA Playoffs - Round 3 - Home Game D,I,0,1070,1070,34:40.4,1
6/29/2021,20PNR3VD,2021 NBA Playoffs - Round 3 - Home Game D,J,0,985,985,34:40.5,1
6/29/2021,20PNR3VD,2021 NBA Playoffs - Round 3 - Home Game D,K,0,915,915,34:40.5,1
6/29/2021,20PNR3VD,2021 NBA Playoffs - Round 3 - Home Game D,L,0,900,900,34:40.7,1
6/29/2021,20PNR3VD,2021 NBA Playoffs - Round 3 - Home Game D,M,0,790,790,34:40.8,1
6/29/2021,20PNR3VD,2021 NBA Playoffs - Round 3 - Home Game D,N,0,1305,1305,34:40.9,1
6/29/2021,20PNR3VD,2021 NBA Playoffs - Round 3 - Home Game D,O,0,1170,1170,34:40.9,1
6/29/2021,20PNR3VD,2021 NBA Playoffs - Round 3 - Home Game D,P,0,1030,1030,34:41.1,1
6/29/2021,20PNR3VD,2021 NBA Playoffs - Round 3 - Home Game D,Q,0,825,825,34:41.2,1
6/29/2021,20PNR3VD,2021 NBA Playoffs - Round 3 - Home Game D,R,0,735,735,34:41.3,1
6/29/2021,20PNR3VD,2021 NBA Playoffs - Round 3 - Home Game D,S,0,735,735,34:41.4,1
6/29/2021,20PNR3VD,2021 NBA Playoffs - Round 3 - Home Game D,T,0,605,605,34:41.5,1
6/29/2021,20PNR3VD,2021 NBA Playoffs - Round 3 - Home Game D,U,0,535,535,34:41.6,1
6/29/2021,20PNR3VD,2021 NBA Playoffs - Round 3 - Home Game D,V,0,485,485,34:41.8,1
6/29/2021,20PNR3VD,2021 NBA Playoffs - Round 3 - Home Game D,W,0,455,455,34:41.9,1
6/29/2021,20PNR3VD,2021 NBA Playoffs - Round 3 - Home Game D,X,0,405,405,34:42.0,1
6/29/2021,20PNR3VD,2021 NBA Playoffs - Round 3 - Home Game D,Y,0,395,395,34:42.1,1
6/29/2021,20PNR3VD,2021 NBA Playoffs - Round 3 - Home Game D,Z,0,1520,1520,34:42.2,1
7/2/2021,20PNR4GA,2021 NBA Playoffs - Round 4 - Home Game A,1,0,236500,236500,33:18.1,1
7/2/2021,20PNR4GA,2021 NBA Playoffs - Round 4 - Home Game A,1,236500,157500,-79000,17:13.7,2
7/2/2021,20PNR4GA,2021 NBA Playoffs - Round 4 - Home Game A,1,157500,12980,-144520,34:56.5,3
7/2/2021,20PNR4GA,2021 NBA Playoffs - Round 4 - Home Game A,2,0,98900,98900,33:18.2,1
7/2/2021,20PNR4GA,2021 NBA Playoffs - Round 4 - Home Game A,2,98900,12980,-85920,34:56.5,2
7/2/2021,20PNR4GA,2021 NBA Playoffs - Round 4 - Home Game A,3,0,85979,85979,33:18.3,1
7/2/2021,20PNR4GA,2021 NBA Playoffs - Round 4 - Home Game A,3,85979,157500,71521,17:13.9,2
7/2/2021,20PNR4GA,2021 NBA Playoffs - Round 4 - Home Game A,3,157500,12980,-144520,34:56.5,3
7/2/2021,20PNR4GA,2021 NBA Playoffs - Round 4 - Home Game A,4,0,47300,47300,33:18.5,1
7/2/2021,20PNR4GA,2021 NBA Playoffs - Round 4 - Home Game A,4,47300,114540,67240,17:14.0,2
7/2/2021,20PNR4GA,2021 NBA Playoffs - Round 4 - Home Game A,4,114540,9440,-105100,34:56.5,3
7/2/2021,20PNR4GA,2021 NBA Playoffs - Round 4 - Home Game A,5,0,43000,43000,33:18.6,1
7/2/2021,20PNR4GA,2021 NBA Playoffs - Round 4 - Home Game A,5,43000,59120,16120,17:14.1,2
7/2/2021,20PNR4GA,2021 NBA Playoffs - Round 4 - Home Game A,5,59120,4200,-54920,34:56.5,3
7/2/2021,20PNR4GA,2021 NBA Playoffs - Round 4 - Home Game A,5,4200,3900,-300,54:56.8,4
7/2/2021,20PNR4GA,2021 NBA Playoffs - Round 4 - Home Game A,5,4200,3900,-300,54:56.8,5
7/2/2021,20PNR4GA,2021 NBA Playoffs - Round 4 - Home Game A,6,0,30100,30100,33:18.6,1
7/2/2021,20PNR4GA,2021 NBA Playoffs - Round 4 - Home Game A,6,30100,41100,11000,17:14.1,2
7/2/2021,20PNR4GA,2021 NBA Playoffs - Round 4 - Home Game A,6,41100,2920,-38180,34:56.5,3
7/2/2021,20PNR4GA,2021 NBA Playoffs - Round 4 - Home Game A,7,23650,38610,14960,17:14.2,1
7/2/2021,20PNR4GA,2021 NBA Playoffs - Round 4 - Home Game A,7,38610,2745,-35865,34:56.5,2
7/2/2021,20PNR4GA,2021 NBA Playoffs - Round 4 - Home Game A,7,2745,2845,100,54:56.8,3
7/2/2021,20PNR4GA,2021 NBA Playoffs - Round 4 - Home Game A,7,2745,2845,100,54:56.8,4
7/2/2021,20PNR4GA,2021 NBA Playoffs - Round 4 - Home Game A,8,18275,32420,14145,17:14.3,1
7/2/2021,20PNR4GA,2021 NBA Playoffs - Round 4 - Home Game A,8,32420,2960,-29460,34:56.5,2
7/2/2021,20PNR4GA,2021 NBA Playoffs - Round 4 - Home Game A,9,17630,31260,13630,17:14.4,1
7/2/2021,20PNR4GA,2021 NBA Playoffs - Round 4 - Home Game A,9,31260,2855,-28405,34:56.5,2
7/2/2021,20PNR4GA,2021 NBA Playoffs - Round 4 - Home Game A,A,0,16770,16770,33:18.8,1
7/2/2021,20PNR4GA,2021 NBA Playoffs - Round 4 - Home Game A,A,16770,29570,12800,17:14.5,2
7/2/2021,20PNR4GA,2021 NBA Playoffs - Round 4 - Home Game A,A,29570,2700,-26870,34:56.5,3
7/2/2021,20PNR4GA,2021 NBA Playoffs - Round 4 - Home Game A,B,0,16125,16125,33:18.9,1
7/2/2021,20PNR4GA,2021 NBA Playoffs - Round 4 - Home Game A,B,16125,26880,10755,17:14.6,2
7/2/2021,20PNR4GA,2021 NBA Playoffs - Round 4 - Home Game A,B,26880,2455,-24425,34:56.5,3
7/2/2021,20PNR4GA,2021 NBA Playoffs - Round 4 - Home Game A,C,0,15050,15050,33:19.0,1
7/2/2021,20PNR4GA,2021 NBA Playoffs - Round 4 - Home Game A,C,15050,24590,9540,17:14.7,2
7/2/2021,20PNR4GA,2021 NBA Playoffs - Round 4 - Home Game A,C,24590,2245,-22345,34:56.5,3
7/2/2021,20PNR4GA,2021 NBA Playoffs - Round 4 - Home Game A,D,0,14190,14190,33:19.1,1
7/2/2021,20PNR4GA,2021 NBA Playoffs - Round 4 - Home Game A,D,14190,23530,9340,17:14.8,2
7/2/2021,20PNR4GA,2021 NBA Playoffs - Round 4 - Home Game A,D,23530,2150,-21380,34:56.5,3
7/2/2021,20PNR4GA,2021 NBA Playoffs - Round 4 - Home Game A,E,0,13330,13330,33:19.2,1
7/2/2021,20PNR4GA,2021 NBA Playoffs - Round 4 - Home Game A,E,13330,19750,6420,17:14.9,2
7/2/2021,20PNR4GA,2021 NBA Playoffs - Round 4 - Home Game A,E,19750,1805,-17945,34:56.5,3
7/2/2021,20PNR4GA,2021 NBA Playoffs - Round 4 - Home Game A,F,0,11395,11395,33:19.3,1
7/2/2021,20PNR4GA,2021 NBA Playoffs - Round 4 - Home Game A,F,11395,18710,7315,17:15.0,2
7/2/2021,20PNR4GA,2021 NBA Playoffs - Round 4 - Home Game A,F,18710,1710,-17000,34:56.5,3
7/2/2021,20PNR4GA,2021 NBA Playoffs - Round 4 - Home Game A,G,0,10965,10965,33:19.4,1
7/2/2021,20PNR4GA,2021 NBA Playoffs - Round 4 - Home Game A,G,10965,17090,6125,17:15.1,2
7/2/2021,20PNR4GA,2021 NBA Playoffs - Round 4 - Home Game A,G,17090,1560,-15530,34:56.5,3
7/2/2021,20PNR4GA,2021 NBA Playoffs - Round 4 - Home Game A,H,0,10535,10535,33:19.5,1
7/2/2021,20PNR4GA,2021 NBA Playoffs - Round 4 - Home Game A,H,10535,15770,5235,17:15.2,2
7/2/2021,20PNR4GA,2021 NBA Playoffs - Round 4 - Home Game A,H,15770,1440,-14330,34:56.5,3
7/2/2021,20PNR4GA,2021 NBA Playoffs - Round 4 - Home Game A,I,0,9030,9030,33:19.6,1
7/2/2021,20PNR4GA,2021 NBA Playoffs - Round 4 - Home Game A,I,9030,14180,5150,17:15.3,2
7/2/2021,20PNR4GA,2021 NBA Playoffs - Round 4 - Home Game A,I,14180,1295,-12885,34:56.5,3
7/2/2021,20PNR4GA,2021 NBA Playoffs - Round 4 - Home Game A,J,0,8385,8385,33:19.7,1
7/2/2021,20PNR4GA,2021 NBA Playoffs - Round 4 - Home Game A,J,8385,13080,4695,17:15.4,2
7/2/2021,20PNR4GA,2021 NBA Playoffs - Round 4 - Home Game A,J,13080,1195,-11885,34:56.5,3
7/2/2021,20PNR4GA,2021 NBA Playoffs - Round 4 - Home Game A,K,0,6880,6880,33:19.8,1
7/2/2021,20PNR4GA,2021 NBA Playoffs - Round 4 - Home Game A,K,6880,12160,5280,17:15.5,2
7/2/2021,20PNR4GA,2021 NBA Playoffs - Round 4 - Home Game A,K,12160,1110,-11050,34:56.5,3
7/2/2021,20PNR4GA,2021 NBA Playoffs - Round 4 - Home Game A,L,0,6450,6450,33:19.9,1
7/2/2021,20PNR4GA,2021 NBA Playoffs - Round 4 - Home Game A,L,6450,11930,5480,17:15.6,2
7/2/2021,20PNR4GA,2021 NBA Playoffs - Round 4 - Home Game A,L,11930,1090,-10840,34:56.5,3
7/2/2021,20PNR4GA,2021 NBA Playoffs - Round 4 - Home Game A,M,0,6020,6020,33:20.0,1
7/2/2021,20PNR4GA,2021 NBA Playoffs - Round 4 - Home Game A,M,6020,10470,4450,17:15.6,2
7/2/2021,20PNR4GA,2021 NBA Playoffs - Round 4 - Home Game A,M,10470,955,-9515,34:56.5,3
7/2/2021,20PNR4GA,2021 NBA Playoffs - Round 4 - Home Game A,N,0,10105,10105,33:20.1,1
7/2/2021,20PNR4GA,2021 NBA Playoffs - Round 4 - Home Game A,N,10105,17290,7185,17:15.7,2
7/2/2021,20PNR4GA,2021 NBA Playoffs - Round 4 - Home Game A,N,17290,1580,-15710,34:56.5,3
7/2/2021,20PNR4GA,2021 NBA Playoffs - Round 4 - Home Game A,O,0,9460,9460,33:20.2,1
7/2/2021,20PNR4GA,2021 NBA Playoffs - Round 4 - Home Game A,O,9460,15550,6090,17:15.8,2
7/2/2021,20PNR4GA,2021 NBA Playoffs - Round 4 - Home Game A,O,15550,1420,-14130,34:56.5,3
7/2/2021,20PNR4GA,2021 NBA Playoffs - Round 4 - Home Game A,P,0,7740,7740,33:20.3,1
7/2/2021,20PNR4GA,2021 NBA Playoffs - Round 4 - Home Game A,P,7740,13670,5930,17:15.9,2
7/2/2021,20PNR4GA,2021 NBA Playoffs - Round 4 - Home Game A,P,13670,1250,-12420,34:56.5,3
7/2/2021,20PNR4GA,2021 NBA Playoffs - Round 4 - Home Game A,Q,0,6880,6880,33:20.4,1
7/2/2021,20PNR4GA,2021 NBA Playoffs - Round 4 - Home Game A,Q,6880,10960,4080,17:16.0,2
7/2/2021,20PNR4GA,2021 NBA Playoffs - Round 4 - Home Game A,Q,10960,1000,-9960,34:56.5,3
7/2/2021,20PNR4GA,2021 NBA Playoffs - Round 4 - Home Game A,R,0,5590,5590,33:20.5,1
7/2/2021,20PNR4GA,2021 NBA Playoffs - Round 4 - Home Game A,R,5590,9740,4150,17:16.1,2
7/2/2021,20PNR4GA,2021 NBA Playoffs - Round 4 - Home Game A,R,9740,890,-8850,34:56.5,3
7/2/2021,20PNR4GA,2021 NBA Playoffs - Round 4 - Home Game A,S,0,5590,5590,33:20.6,1
7/2/2021,20PNR4GA,2021 NBA Playoffs - Round 4 - Home Game A,S,5590,9740,4150,17:16.2,2
7/2/2021,20PNR4GA,2021 NBA Playoffs - Round 4 - Home Game A,S,9740,890,-8850,34:56.5,3
7/2/2021,20PNR4GA,2021 NBA Playoffs - Round 4 - Home Game A,T,0,4730,4730,33:20.7,1
7/2/2021,20PNR4GA,2021 NBA Playoffs - Round 4 - Home Game A,T,4730,8030,3300,17:16.3,2
7/2/2021,20PNR4GA,2021 NBA Playoffs - Round 4 - Home Game A,T,8030,735,-7295,34:56.5,3
7/2/2021,20PNR4GA,2021 NBA Playoffs - Round 4 - Home Game A,U,0,3870,3870,33:20.8,1
7/2/2021,20PNR4GA,2021 NBA Playoffs - Round 4 - Home Game A,U,3870,7130,3260,17:16.4,2
7/2/2021,20PNR4GA,2021 NBA Playoffs - Round 4 - Home Game A,U,7130,650,-6480,34:56.5,3
7/2/2021,20PNR4GA,2021 NBA Playoffs - Round 4 - Home Game A,V,0,3440,3440,33:20.9,1
7/2/2021,20PNR4GA,2021 NBA Playoffs - Round 4 - Home Game A,V,3440,6430,2990,17:16.4,2
7/2/2021,20PNR4GA,2021 NBA Playoffs - Round 4 - Home Game A,V,6430,585,-5845,34:56.5,3
7/2/2021,20PNR4GA,2021 NBA Playoffs - Round 4 - Home Game A,W,0,3010,3010,33:21.0,1
7/2/2021,20PNR4GA,2021 NBA Playoffs - Round 4 - Home Game A,W,3010,6030,3020,17:16.5,2
7/2/2021,20PNR4GA,2021 NBA Playoffs - Round 4 - Home Game A,W,6030,550,-5480,34:56.5,3
7/2/2021,20PNR4GA,2021 NBA Playoffs - Round 4 - Home Game A,X,0,2795,2795,33:21.1,1
7/2/2021,20PNR4GA,2021 NBA Playoffs - Round 4 - Home Game A,X,2795,5370,2575,17:16.6,2
7/2/2021,20PNR4GA,2021 NBA Playoffs - Round 4 - Home Game A,X,5370,490,-4880,34:56.5,3
7/2/2021,20PNR4GA,2021 NBA Playoffs - Round 4 - Home Game A,Y,0,2795,2795,33:21.2,1
7/2/2021,20PNR4GA,2021 NBA Playoffs - Round 4 - Home Game A,Y,2795,5220,2425,17:16.7,2
7/2/2021,20PNR4GA,2021 NBA Playoffs - Round 4 - Home Game A,Y,5220,475,-4745,34:56.5,3
7/2/2021,20PNR4GA,2021 NBA Playoffs - Round 4 - Home Game A,Z,0,999999,999999,33:21.3,1
7/2/2021,20PNR4GA,2021 NBA Playoffs - Round 4 - Home Game A,Z,999999,20190,-979809,17:16.8,2
7/2/2021,20PNR4GA,2021 NBA Playoffs - Round 4 - Home Game A,Z,20190,1845,-18345,34:56.5,3
7/2/2021,20PNR4VA,2021 NBA Playoffs - Round 4 - Home Game A,1,0,12980,12980,35:39.5,1
7/2/2021,20PNR4VA,2021 NBA Playoffs - Round 4 - Home Game A,2,0,12980,12980,35:39.6,1
7/2/2021,20PNR4VA,2021 NBA Playoffs - Round 4 - Home Game A,3,0,12980,12980,35:39.7,1
7/2/2021,20PNR4VA,2021 NBA Playoffs - Round 4 - Home Game A,4,0,9440,9440,35:39.7,1
7/2/2021,20PNR4VA,2021 NBA Playoffs - Round 4 - Home Game A,5,0,3900,3900,35:39.8,1
7/2/2021,20PNR4VA,2021 NBA Playoffs - Round 4 - Home Game A,6,0,2920,2920,35:39.9,1
7/2/2021,20PNR4VA,2021 NBA Playoffs - Round 4 - Home Game A,A,0,2700,2700,35:40.0,1
7/2/2021,20PNR4VA,2021 NBA Playoffs - Round 4 - Home Game A,B,0,2455,2455,35:40.2,1
7/2/2021,20PNR4VA,2021 NBA Playoffs - Round 4 - Home Game A,C,0,2245,2245,35:40.3,1
7/2/2021,20PNR4VA,2021 NBA Playoffs - Round 4 - Home Game A,D,0,2150,2150,35:40.4,1
7/2/2021,20PNR4VA,2021 NBA Playoffs - Round 4 - Home Game A,E,0,1805,1805,35:40.5,1
7/2/2021,20PNR4VA,2021 NBA Playoffs - Round 4 - Home Game A,F,0,1710,1710,35:40.6,1
7/2/2021,20PNR4VA,2021 NBA Playoffs - Round 4 - Home Game A,G,0,1560,1560,35:40.7,1
7/2/2021,20PNR4VA,2021 NBA Playoffs - Round 4 - Home Game A,H,0,1440,1440,35:40.8,1
7/2/2021,20PNR4VA,2021 NBA Playoffs - Round 4 - Home Game A,I,0,1295,1295,35:40.9,1
7/2/2021,20PNR4VA,2021 NBA Playoffs - Round 4 - Home Game A,J,0,1195,1195,35:41.0,1
7/2/2021,20PNR4VA,2021 NBA Playoffs - Round 4 - Home Game A,K,0,1110,1110,35:41.1,1
7/2/2021,20PNR4VA,2021 NBA Playoffs - Round 4 - Home Game A,L,0,1090,1090,35:41.2,1
7/2/2021,20PNR4VA,2021 NBA Playoffs - Round 4 - Home Game A,M,0,955,955,35:41.3,1
7/2/2021,20PNR4VA,2021 NBA Playoffs - Round 4 - Home Game A,N,0,1580,1580,35:41.4,1
7/2/2021,20PNR4VA,2021 NBA Playoffs - Round 4 - Home Game A,O,0,1420,1420,35:41.5,1
7/2/2021,20PNR4VA,2021 NBA Playoffs - Round 4 - Home Game A,P,0,1250,1250,35:41.6,1
7/2/2021,20PNR4VA,2021 NBA Playoffs - Round 4 - Home Game A,Q,0,1000,1000,35:41.7,1
7/2/2021,20PNR4VA,2021 NBA Playoffs - Round 4 - Home Game A,R,0,890,890,35:41.8,1
7/2/2021,20PNR4VA,2021 NBA Playoffs - Round 4 - Home Game A,S,0,890,890,35:41.9,1
7/2/2021,20PNR4VA,2021 NBA Playoffs - Round 4 - Home Game A,T,0,735,735,35:42.0,1
7/2/2021,20PNR4VA,2021 NBA Playoffs - Round 4 - Home Game A,U,0,650,650,35:42.1,1
7/2/2021,20PNR4VA,2021 NBA Playoffs - Round 4 - Home Game A,V,0,585,585,35:42.2,1
7/2/2021,20PNR4VA,2021 NBA Playoffs - Round 4 - Home Game A,W,0,550,550,35:42.3,1
7/2/2021,20PNR4VA,2021 NBA Playoffs - Round 4 - Home Game A,X,0,490,490,35:42.4,1
7/2/2021,20PNR4VA,2021 NBA Playoffs - Round 4 - Home Game A,Y,0,475,475,35:42.5,1
7/2/2021,20PNR4VA,2021 NBA Playoffs - Round 4 - Home Game A,Z,0,1845,1845,35:42.6,1
7/5/2021,20PNR4GB,2021 NBA Playoffs - Round 4 - Home Game B,1,0,236500,236500,33:21.4,1
7/5/2021,20PNR4GB,2021 NBA Playoffs - Round 4 - Home Game B,1,236500,157500,-79000,17:16.9,2
7/5/2021,20PNR4GB,2021 NBA Playoffs - Round 4 - Home Game B,1,157500,12980,-144520,34:56.5,3
7/5/2021,20PNR4GB,2021 NBA Playoffs - Round 4 - Home Game B,2,0,98900,98900,33:21.5,1
7/5/2021,20PNR4GB,2021 NBA Playoffs - Round 4 - Home Game B,2,98900,12980,-85920,34:56.5,2
7/5/2021,20PNR4GB,2021 NBA Playoffs - Round 4 - Home Game B,3,0,85979,85979,33:21.6,1
7/5/2021,20PNR4GB,2021 NBA Playoffs - Round 4 - Home Game B,3,85979,157500,71521,17:17.0,2
7/5/2021,20PNR4GB,2021 NBA Playoffs - Round 4 - Home Game B,3,157500,12980,-144520,34:56.5,3
7/5/2021,20PNR4GB,2021 NBA Playoffs - Round 4 - Home Game B,4,0,47300,47300,33:21.7,1
7/5/2021,20PNR4GB,2021 NBA Playoffs - Round 4 - Home Game B,4,47300,114540,67240,17:17.1,2
7/5/2021,20PNR4GB,2021 NBA Playoffs - Round 4 - Home Game B,4,114540,9440,-105100,34:56.5,3
7/5/2021,20PNR4GB,2021 NBA Playoffs - Round 4 - Home Game B,5,0,43000,43000,33:21.8,1
7/5/2021,20PNR4GB,2021 NBA Playoffs - Round 4 - Home Game B,5,43000,59120,16120,17:17.2,2
7/5/2021,20PNR4GB,2021 NBA Playoffs - Round 4 - Home Game B,5,59120,4200,-54920,34:56.5,3
7/5/2021,20PNR4GB,2021 NBA Playoffs - Round 4 - Home Game B,5,4200,3900,-300,54:56.8,4
7/5/2021,20PNR4GB,2021 NBA Playoffs - Round 4 - Home Game B,5,4200,3900,-300,54:56.8,5
7/5/2021,20PNR4GB,2021 NBA Playoffs - Round 4 - Home Game B,6,0,30100,30100,33:21.8,1
7/5/2021,20PNR4GB,2021 NBA Playoffs - Round 4 - Home Game B,6,30100,41100,11000,17:17.3,2
7/5/2021,20PNR4GB,2021 NBA Playoffs - Round 4 - Home Game B,6,41100,2920,-38180,34:56.5,3
7/5/2021,20PNR4GB,2021 NBA Playoffs - Round 4 - Home Game B,7,23650,38610,14960,17:17.4,1
7/5/2021,20PNR4GB,2021 NBA Playoffs - Round 4 - Home Game B,7,38610,2745,-35865,34:56.5,2
7/5/2021,20PNR4GB,2021 NBA Playoffs - Round 4 - Home Game B,7,2745,2845,100,54:56.8,3
7/5/2021,20PNR4GB,2021 NBA Playoffs - Round 4 - Home Game B,7,2745,2845,100,54:56.8,4
7/5/2021,20PNR4GB,2021 NBA Playoffs - Round 4 - Home Game B,8,18275,32420,14145,17:17.5,1
7/5/2021,20PNR4GB,2021 NBA Playoffs - Round 4 - Home Game B,8,32420,2960,-29460,34:56.5,2
7/5/2021,20PNR4GB,2021 NBA Playoffs - Round 4 - Home Game B,9,17630,31260,13630,17:17.6,1
7/5/2021,20PNR4GB,2021 NBA Playoffs - Round 4 - Home Game B,9,31260,2855,-28405,34:56.5,2
7/5/2021,20PNR4GB,2021 NBA Playoffs - Round 4 - Home Game B,A,0,16770,16770,33:22.0,1
7/5/2021,20PNR4GB,2021 NBA Playoffs - Round 4 - Home Game B,A,16770,29570,12800,17:17.7,2
7/5/2021,20PNR4GB,2021 NBA Playoffs - Round 4 - Home Game B,A,29570,2700,-26870,34:56.5,3
7/5/2021,20PNR4GB,2021 NBA Playoffs - Round 4 - Home Game B,B,0,16125,16125,33:22.1,1
7/5/2021,20PNR4GB,2021 NBA Playoffs - Round 4 - Home Game B,B,16125,26880,10755,17:17.8,2
7/5/2021,20PNR4GB,2021 NBA Playoffs - Round 4 - Home Game B,B,26880,2455,-24425,34:56.5,3
7/5/2021,20PNR4GB,2021 NBA Playoffs - Round 4 - Home Game B,C,0,15050,15050,33:22.2,1
7/5/2021,20PNR4GB,2021 NBA Playoffs - Round 4 - Home Game B,C,15050,24590,9540,17:17.9,2
7/5/2021,20PNR4GB,2021 NBA Playoffs - Round 4 - Home Game B,C,24590,2245,-22345,34:56.5,3
7/5/2021,20PNR4GB,2021 NBA Playoffs - Round 4 - Home Game B,D,0,14190,14190,33:22.3,1
7/5/2021,20PNR4GB,2021 NBA Playoffs - Round 4 - Home Game B,D,14190,23530,9340,17:18.0,2
7/5/2021,20PNR4GB,2021 NBA Playoffs - Round 4 - Home Game B,D,23530,2150,-21380,34:56.5,3
7/5/2021,20PNR4GB,2021 NBA Playoffs - Round 4 - Home Game B,E,0,13330,13330,33:22.4,1
7/5/2021,20PNR4GB,2021 NBA Playoffs - Round 4 - Home Game B,E,13330,19750,6420,17:18.1,2
7/5/2021,20PNR4GB,2021 NBA Playoffs - Round 4 - Home Game B,E,19750,1805,-17945,34:56.5,3
7/5/2021,20PNR4GB,2021 NBA Playoffs - Round 4 - Home Game B,F,0,11395,11395,33:22.5,1
7/5/2021,20PNR4GB,2021 NBA Playoffs - Round 4 - Home Game B,F,11395,18710,7315,17:18.2,2
7/5/2021,20PNR4GB,2021 NBA Playoffs - Round 4 - Home Game B,F,18710,1710,-17000,34:56.5,3
7/5/2021,20PNR4GB,2021 NBA Playoffs - Round 4 - Home Game B,G,0,10965,10965,33:22.6,1
7/5/2021,20PNR4GB,2021 NBA Playoffs - Round 4 - Home Game B,G,10965,17090,6125,17:18.3,2
7/5/2021,20PNR4GB,2021 NBA Playoffs - Round 4 - Home Game B,G,17090,1560,-15530,34:56.5,3
7/5/2021,20PNR4GB,2021 NBA Playoffs - Round 4 - Home Game B,H,0,10535,10535,33:22.7,1
7/5/2021,20PNR4GB,2021 NBA Playoffs - Round 4 - Home Game B,H,10535,15770,5235,17:18.4,2
7/5/2021,20PNR4GB,2021 NBA Playoffs - Round 4 - Home Game B,H,15770,1440,-14330,34:56.5,3
7/5/2021,20PNR4GB,2021 NBA Playoffs - Round 4 - Home Game B,I,0,9030,9030,33:22.8,1
7/5/2021,20PNR4GB,2021 NBA Playoffs - Round 4 - Home Game B,I,9030,14180,5150,17:18.5,2
7/5/2021,20PNR4GB,2021 NBA Playoffs - Round 4 - Home Game B,I,14180,1295,-12885,34:56.5,3
7/5/2021,20PNR4GB,2021 NBA Playoffs - Round 4 - Home Game B,J,0,8385,8385,33:22.9,1
7/5/2021,20PNR4GB,2021 NBA Playoffs - Round 4 - Home Game B,J,8385,13080,4695,17:18.6,2
7/5/2021,20PNR4GB,2021 NBA Playoffs - Round 4 - Home Game B,J,13080,1195,-11885,34:56.5,3
7/5/2021,20PNR4GB,2021 NBA Playoffs - Round 4 - Home Game B,K,0,6880,6880,33:23.0,1
7/5/2021,20PNR4GB,2021 NBA Playoffs - Round 4 - Home Game B,K,6880,12160,5280,17:18.7,2
7/5/2021,20PNR4GB,2021 NBA Playoffs - Round 4 - Home Game B,K,12160,1110,-11050,34:56.5,3
7/5/2021,20PNR4GB,2021 NBA Playoffs - Round 4 - Home Game B,L,0,6450,6450,33:23.1,1
7/5/2021,20PNR4GB,2021 NBA Playoffs - Round 4 - Home Game B,L,6450,11930,5480,17:18.7,2
7/5/2021,20PNR4GB,2021 NBA Playoffs - Round 4 - Home Game B,L,11930,1090,-10840,34:56.5,3
7/5/2021,20PNR4GB,2021 NBA Playoffs - Round 4 - Home Game B,M,0,6020,6020,33:23.2,1
7/5/2021,20PNR4GB,2021 NBA Playoffs - Round 4 - Home Game B,M,6020,10470,4450,17:18.8,2
7/5/2021,20PNR4GB,2021 NBA Playoffs - Round 4 - Home Game B,M,10470,955,-9515,34:56.5,3
7/5/2021,20PNR4GB,2021 NBA Playoffs - Round 4 - Home Game B,N,0,10105,10105,33:23.3,1
7/5/2021,20PNR4GB,2021 NBA Playoffs - Round 4 - Home Game B,N,10105,17290,7185,17:18.9,2
7/5/2021,20PNR4GB,2021 NBA Playoffs - Round 4 - Home Game B,N,17290,1580,-15710,34:56.5,3
7/5/2021,20PNR4GB,2021 NBA Playoffs - Round 4 - Home Game B,O,0,9460,9460,33:23.4,1
7/5/2021,20PNR4GB,2021 NBA Playoffs - Round 4 - Home Game B,O,9460,15550,6090,17:19.0,2
7/5/2021,20PNR4GB,2021 NBA Playoffs - Round 4 - Home Game B,O,15550,1420,-14130,34:56.5,3
7/5/2021,20PNR4GB,2021 NBA Playoffs - Round 4 - Home Game B,P,0,7740,7740,33:23.5,1
7/5/2021,20PNR4GB,2021 NBA Playoffs - Round 4 - Home Game B,P,7740,13670,5930,17:19.1,2
7/5/2021,20PNR4GB,2021 NBA Playoffs - Round 4 - Home Game B,P,13670,1250,-12420,34:56.5,3
7/5/2021,20PNR4GB,2021 NBA Playoffs - Round 4 - Home Game B,Q,0,6880,6880,33:23.5,1
7/5/2021,20PNR4GB,2021 NBA Playoffs - Round 4 - Home Game B,Q,6880,10960,4080,17:19.2,2
7/5/2021,20PNR4GB,2021 NBA Playoffs - Round 4 - Home Game B,Q,10960,1000,-9960,34:56.5,3
7/5/2021,20PNR4GB,2021 NBA Playoffs - Round 4 - Home Game B,R,0,5590,5590,33:23.6,1
7/5/2021,20PNR4GB,2021 NBA Playoffs - Round 4 - Home Game B,R,5590,9740,4150,17:19.3,2
7/5/2021,20PNR4GB,2021 NBA Playoffs - Round 4 - Home Game B,R,9740,890,-8850,34:56.5,3
7/5/2021,20PNR4GB,2021 NBA Playoffs - Round 4 - Home Game B,S,0,5590,5590,33:23.7,1
7/5/2021,20PNR4GB,2021 NBA Playoffs - Round 4 - Home Game B,S,5590,9740,4150,17:19.3,2
7/5/2021,20PNR4GB,2021 NBA Playoffs - Round 4 - Home Game B,S,9740,890,-8850,34:56.5,3
7/5/2021,20PNR4GB,2021 NBA Playoffs - Round 4 - Home Game B,T,0,4730,4730,33:23.8,1
7/5/2021,20PNR4GB,2021 NBA Playoffs - Round 4 - Home Game B,T,4730,8030,3300,17:19.4,2
7/5/2021,20PNR4GB,2021 NBA Playoffs - Round 4 - Home Game B,T,8030,735,-7295,34:56.5,3
7/5/2021,20PNR4GB,2021 NBA Playoffs - Round 4 - Home Game B,U,0,3870,3870,33:23.9,1
7/5/2021,20PNR4GB,2021 NBA Playoffs - Round 4 - Home Game B,U,3870,7130,3260,17:19.5,2
7/5/2021,20PNR4GB,2021 NBA Playoffs - Round 4 - Home Game B,U,7130,650,-6480,34:56.5,3
7/5/2021,20PNR4GB,2021 NBA Playoffs - Round 4 - Home Game B,V,0,3440,3440,33:24.0,1
7/5/2021,20PNR4GB,2021 NBA Playoffs - Round 4 - Home Game B,V,3440,6430,2990,17:19.6,2
7/5/2021,20PNR4GB,2021 NBA Playoffs - Round 4 - Home Game B,V,6430,585,-5845,34:56.5,3
7/5/2021,20PNR4GB,2021 NBA Playoffs - Round 4 - Home Game B,W,0,3010,3010,33:24.1,1
7/5/2021,20PNR4GB,2021 NBA Playoffs - Round 4 - Home Game B,W,3010,6030,3020,17:19.7,2
7/5/2021,20PNR4GB,2021 NBA Playoffs - Round 4 - Home Game B,W,6030,550,-5480,34:56.5,3
7/5/2021,20PNR4GB,2021 NBA Playoffs - Round 4 - Home Game B,X,0,2795,2795,33:24.2,1
7/5/2021,20PNR4GB,2021 NBA Playoffs - Round 4 - Home Game B,X,2795,5370,2575,17:19.8,2
7/5/2021,20PNR4GB,2021 NBA Playoffs - Round 4 - Home Game B,X,5370,490,-4880,34:56.5,3
7/5/2021,20PNR4GB,2021 NBA Playoffs - Round 4 - Home Game B,Y,0,2795,2795,33:24.3,1
7/5/2021,20PNR4GB,2021 NBA Playoffs - Round 4 - Home Game B,Y,2795,5220,2425,17:19.9,2
7/5/2021,20PNR4GB,2021 NBA Playoffs - Round 4 - Home Game B,Y,5220,475,-4745,34:56.5,3
7/5/2021,20PNR4GB,2021 NBA Playoffs - Round 4 - Home Game B,Z,0,999999,999999,33:24.4,1
7/5/2021,20PNR4GB,2021 NBA Playoffs - Round 4 - Home Game B,Z,999999,20190,-979809,17:20.0,2
7/5/2021,20PNR4GB,2021 NBA Playoffs - Round 4 - Home Game B,Z,20190,1845,-18345,34:56.5,3
7/5/2021,20PNR4VB,2021 NBA Playoffs - Round 4 - Home Game B,1,0,12980,12980,36:37.7,1
7/5/2021,20PNR4VB,2021 NBA Playoffs - Round 4 - Home Game B,2,0,12980,12980,36:37.8,1
7/5/2021,20PNR4VB,2021 NBA Playoffs - Round 4 - Home Game B,3,0,12980,12980,36:37.9,1
7/5/2021,20PNR4VB,2021 NBA Playoffs - Round 4 - Home Game B,4,0,9440,9440,36:38.0,1
7/5/2021,20PNR4VB,2021 NBA Playoffs - Round 4 - Home Game B,5,0,3900,3900,36:38.1,1
7/5/2021,20PNR4VB,2021 NBA Playoffs - Round 4 - Home Game B,6,0,2920,2920,36:38.2,1
7/5/2021,20PNR4VB,2021 NBA Playoffs - Round 4 - Home Game B,A,0,2700,2700,36:38.3,1
7/5/2021,20PNR4VB,2021 NBA Playoffs - Round 4 - Home Game B,B,0,2455,2455,36:38.4,1
7/5/2021,20PNR4VB,2021 NBA Playoffs - Round 4 - Home Game B,C,0,2245,2245,36:38.5,1
7/5/2021,20PNR4VB,2021 NBA Playoffs - Round 4 - Home Game B,D,0,2150,2150,36:38.6,1
7/5/2021,20PNR4VB,2021 NBA Playoffs - Round 4 - Home Game B,E,0,1805,1805,36:38.7,1
7/5/2021,20PNR4VB,2021 NBA Playoffs - Round 4 - Home Game B,F,0,1710,1710,36:38.8,1
7/5/2021,20PNR4VB,2021 NBA Playoffs - Round 4 - Home Game B,G,0,1560,1560,36:38.9,1
7/5/2021,20PNR4VB,2021 NBA Playoffs - Round 4 - Home Game B,H,0,1440,1440,36:39.0,1
7/5/2021,20PNR4VB,2021 NBA Playoffs - Round 4 - Home Game B,I,0,1295,1295,36:39.1,1
7/5/2021,20PNR4VB,2021 NBA Playoffs - Round 4 - Home Game B,J,0,1195,1195,36:39.2,1
7/5/2021,20PNR4VB,2021 NBA Playoffs - Round 4 - Home Game B,K,0,1110,1110,36:39.3,1
7/5/2021,20PNR4VB,2021 NBA Playoffs - Round 4 - Home Game B,L,0,1090,1090,36:39.4,1
7/5/2021,20PNR4VB,2021 NBA Playoffs - Round 4 - Home Game B,M,0,955,955,36:39.5,1
7/5/2021,20PNR4VB,2021 NBA Playoffs - Round 4 - Home Game B,N,0,1580,1580,36:39.6,1
7/5/2021,20PNR4VB,2021 NBA Playoffs - Round 4 - Home Game B,O,0,1420,1420,36:39.7,1
7/5/2021,20PNR4VB,2021 NBA Playoffs - Round 4 - Home Game B,P,0,1250,1250,36:39.8,1
7/5/2021,20PNR4VB,2021 NBA Playoffs - Round 4 - Home Game B,Q,0,1000,1000,36:39.9,1
7/5/2021,20PNR4VB,2021 NBA Playoffs - Round 4 - Home Game B,R,0,890,890,36:40.0,1
7/5/2021,20PNR4VB,2021 NBA Playoffs - Round 4 - Home Game B,S,0,890,890,36:40.1,1
7/5/2021,20PNR4VB,2021 NBA Playoffs - Round 4 - Home Game B,T,0,735,735,36:40.2,1
7/5/2021,20PNR4VB,2021 NBA Playoffs - Round 4 - Home Game B,U,0,650,650,36:40.3,1
7/5/2021,20PNR4VB,2021 NBA Playoffs - Round 4 - Home Game B,V,0,585,585,36:40.4,1
7/5/2021,20PNR4VB,2021 NBA Playoffs - Round 4 - Home Game B,W,0,550,550,36:40.5,1
7/5/2021,20PNR4VB,2021 NBA Playoffs - Round 4 - Home Game B,X,0,490,490,36:40.6,1
7/5/2021,20PNR4VB,2021 NBA Playoffs - Round 4 - Home Game B,Y,0,475,475,36:40.8,1
7/5/2021,20PNR4VB,2021 NBA Playoffs - Round 4 - Home Game B,Z,0,1845,1845,36:40.9,1
7/8/2021,20PNR4GC,2021 NBA Playoffs - Round 4 - Home Game C,1,0,236500,236500,33:24.5,1
7/8/2021,20PNR4GC,2021 NBA Playoffs - Round 4 - Home Game C,1,236500,157500,-79000,17:20.1,2
7/8/2021,20PNR4GC,2021 NBA Playoffs - Round 4 - Home Game C,1,157500,15000,-142500,34:56.5,3
7/8/2021,20PNR4GC,2021 NBA Playoffs - Round 4 - Home Game C,2,0,98900,98900,33:24.6,1
7/8/2021,20PNR4GC,2021 NBA Playoffs - Round 4 - Home Game C,2,98900,15000,-83900,34:56.5,2
7/8/2021,20PNR4GC,2021 NBA Playoffs - Round 4 - Home Game C,3,0,85979,85979,33:24.7,1
7/8/2021,20PNR4GC,2021 NBA Playoffs - Round 4 - Home Game C,3,85979,157500,71521,17:20.2,2
7/8/2021,20PNR4GC,2021 NBA Playoffs - Round 4 - Home Game C,3,157500,15000,-142500,34:56.5,3
7/8/2021,20PNR4GC,2021 NBA Playoffs - Round 4 - Home Game C,4,0,47300,47300,33:24.8,1
7/8/2021,20PNR4GC,2021 NBA Playoffs - Round 4 - Home Game C,4,47300,114540,67240,17:20.3,2
7/8/2021,20PNR4GC,2021 NBA Playoffs - Round 4 - Home Game C,4,114540,10910,-103630,34:56.5,3
7/8/2021,20PNR4GC,2021 NBA Playoffs - Round 4 - Home Game C,5,0,43000,43000,33:24.9,1
7/8/2021,20PNR4GC,2021 NBA Playoffs - Round 4 - Home Game C,5,43000,59120,16120,17:20.4,2
7/8/2021,20PNR4GC,2021 NBA Playoffs - Round 4 - Home Game C,5,59120,5335,-53785,34:56.5,3
7/8/2021,20PNR4GC,2021 NBA Playoffs - Round 4 - Home Game C,5,5335,4955,-380,54:56.8,4
7/8/2021,20PNR4GC,2021 NBA Playoffs - Round 4 - Home Game C,5,5335,4955,-380,54:56.8,5
7/8/2021,20PNR4GC,2021 NBA Playoffs - Round 4 - Home Game C,6,0,30100,30100,33:25.0,1
7/8/2021,20PNR4GC,2021 NBA Playoffs - Round 4 - Home Game C,6,30100,41100,11000,17:20.5,2
7/8/2021,20PNR4GC,2021 NBA Playoffs - Round 4 - Home Game C,6,41100,3710,-37390,34:56.5,3
7/8/2021,20PNR4GC,2021 NBA Playoffs - Round 4 - Home Game C,7,23650,38610,14960,17:20.6,1
7/8/2021,20PNR4GC,2021 NBA Playoffs - Round 4 - Home Game C,7,38610,3485,-35125,34:56.5,2
7/8/2021,20PNR4GC,2021 NBA Playoffs - Round 4 - Home Game C,7,3485,3615,130,54:56.8,3
7/8/2021,20PNR4GC,2021 NBA Playoffs - Round 4 - Home Game C,7,3485,3615,130,54:56.8,4
7/8/2021,20PNR4GC,2021 NBA Playoffs - Round 4 - Home Game C,8,18275,32420,14145,17:20.7,1
7/8/2021,20PNR4GC,2021 NBA Playoffs - Round 4 - Home Game C,8,32420,3760,-28660,34:56.5,2
7/8/2021,20PNR4GC,2021 NBA Playoffs - Round 4 - Home Game C,9,17630,31260,13630,17:20.8,1
7/8/2021,20PNR4GC,2021 NBA Playoffs - Round 4 - Home Game C,9,31260,3625,-27635,34:56.5,2
7/8/2021,20PNR4GC,2021 NBA Playoffs - Round 4 - Home Game C,A,0,16770,16770,33:25.0,1
7/8/2021,20PNR4GC,2021 NBA Playoffs - Round 4 - Home Game C,A,16770,29570,12800,17:20.9,2
7/8/2021,20PNR4GC,2021 NBA Playoffs - Round 4 - Home Game C,A,29570,3430,-26140,34:56.5,3
7/8/2021,20PNR4GC,2021 NBA Playoffs - Round 4 - Home Game C,B,0,16125,16125,33:25.1,1
7/8/2021,20PNR4GC,2021 NBA Playoffs - Round 4 - Home Game C,B,16125,26880,10755,17:21.0,2
7/8/2021,20PNR4GC,2021 NBA Playoffs - Round 4 - Home Game C,B,26880,3120,-23760,34:56.5,3
7/8/2021,20PNR4GC,2021 NBA Playoffs - Round 4 - Home Game C,C,0,15050,15050,33:25.2,1
7/8/2021,20PNR4GC,2021 NBA Playoffs - Round 4 - Home Game C,C,15050,24590,9540,17:21.1,2
7/8/2021,20PNR4GC,2021 NBA Playoffs - Round 4 - Home Game C,C,24590,2850,-21740,34:56.5,3
7/8/2021,20PNR4GC,2021 NBA Playoffs - Round 4 - Home Game C,D,0,14190,14190,33:25.3,1
7/8/2021,20PNR4GC,2021 NBA Playoffs - Round 4 - Home Game C,D,14190,23530,9340,17:21.2,2
7/8/2021,20PNR4GC,2021 NBA Playoffs - Round 4 - Home Game C,D,23530,2730,-20800,34:56.5,3
7/8/2021,20PNR4GC,2021 NBA Playoffs - Round 4 - Home Game C,E,0,13330,13330,33:25.4,1
7/8/2021,20PNR4GC,2021 NBA Playoffs - Round 4 - Home Game C,E,13330,19750,6420,17:21.3,2
7/8/2021,20PNR4GC,2021 NBA Playoffs - Round 4 - Home Game C,E,19750,2290,-17460,34:56.5,3
7/8/2021,20PNR4GC,2021 NBA Playoffs - Round 4 - Home Game C,F,0,11395,11395,33:25.5,1
7/8/2021,20PNR4GC,2021 NBA Playoffs - Round 4 - Home Game C,F,11395,18710,7315,17:21.4,2
7/8/2021,20PNR4GC,2021 NBA Playoffs - Round 4 - Home Game C,F,18710,2170,-16540,34:56.5,3
7/8/2021,20PNR4GC,2021 NBA Playoffs - Round 4 - Home Game C,G,0,10965,10965,33:25.6,1
7/8/2021,20PNR4GC,2021 NBA Playoffs - Round 4 - Home Game C,G,10965,17090,6125,17:21.4,2
7/8/2021,20PNR4GC,2021 NBA Playoffs - Round 4 - Home Game C,G,17090,1980,-15110,34:56.5,3
7/8/2021,20PNR4GC,2021 NBA Playoffs - Round 4 - Home Game C,H,0,10535,10535,33:25.7,1
7/8/2021,20PNR4GC,2021 NBA Playoffs - Round 4 - Home Game C,H,10535,15770,5235,17:21.5,2
7/8/2021,20PNR4GC,2021 NBA Playoffs - Round 4 - Home Game C,H,15770,1830,-13940,34:56.5,3
7/8/2021,20PNR4GC,2021 NBA Playoffs - Round 4 - Home Game C,I,0,9030,9030,33:25.8,1
7/8/2021,20PNR4GC,2021 NBA Playoffs - Round 4 - Home Game C,I,9030,14180,5150,17:21.6,2
7/8/2021,20PNR4GC,2021 NBA Playoffs - Round 4 - Home Game C,I,14180,1645,-12535,34:56.5,3
7/8/2021,20PNR4GC,2021 NBA Playoffs - Round 4 - Home Game C,J,0,8385,8385,33:25.9,1
7/8/2021,20PNR4GC,2021 NBA Playoffs - Round 4 - Home Game C,J,8385,13080,4695,17:21.7,2
7/8/2021,20PNR4GC,2021 NBA Playoffs - Round 4 - Home Game C,J,13080,1520,-11560,34:56.5,3
7/8/2021,20PNR4GC,2021 NBA Playoffs - Round 4 - Home Game C,K,0,6880,6880,33:26.0,1
7/8/2021,20PNR4GC,2021 NBA Playoffs - Round 4 - Home Game C,K,6880,12160,5280,17:21.8,2
7/8/2021,20PNR4GC,2021 NBA Playoffs - Round 4 - Home Game C,K,12160,1410,-10750,34:56.5,3
7/8/2021,20PNR4GC,2021 NBA Playoffs - Round 4 - Home Game C,L,0,6450,6450,33:26.1,1
7/8/2021,20PNR4GC,2021 NBA Playoffs - Round 4 - Home Game C,L,6450,11930,5480,17:21.9,2
7/8/2021,20PNR4GC,2021 NBA Playoffs - Round 4 - Home Game C,L,11930,1385,-10545,34:56.5,3
7/8/2021,20PNR4GC,2021 NBA Playoffs - Round 4 - Home Game C,M,0,6020,6020,33:26.2,1
7/8/2021,20PNR4GC,2021 NBA Playoffs - Round 4 - Home Game C,M,6020,10470,4450,17:22.0,2
7/8/2021,20PNR4GC,2021 NBA Playoffs - Round 4 - Home Game C,M,10470,1215,-9255,34:56.5,3
7/8/2021,20PNR4GC,2021 NBA Playoffs - Round 4 - Home Game C,N,0,10105,10105,33:26.3,1
7/8/2021,20PNR4GC,2021 NBA Playoffs - Round 4 - Home Game C,N,10105,17290,7185,17:22.1,2
7/8/2021,20PNR4GC,2021 NBA Playoffs - Round 4 - Home Game C,N,17290,2005,-15285,34:56.5,3
7/8/2021,20PNR4GC,2021 NBA Playoffs - Round 4 - Home Game C,O,0,9460,9460,33:26.3,1
7/8/2021,20PNR4GC,2021 NBA Playoffs - Round 4 - Home Game C,O,9460,15550,6090,17:22.2,2
7/8/2021,20PNR4GC,2021 NBA Playoffs - Round 4 - Home Game C,O,15550,1805,-13745,34:56.5,3
7/8/2021,20PNR4GC,2021 NBA Playoffs - Round 4 - Home Game C,P,0,7740,7740,33:26.4,1
7/8/2021,20PNR4GC,2021 NBA Playoffs - Round 4 - Home Game C,P,7740,13670,5930,17:22.3,2
7/8/2021,20PNR4GC,2021 NBA Playoffs - Round 4 - Home Game C,P,13670,1590,-12080,34:56.5,3
7/8/2021,20PNR4GC,2021 NBA Playoffs - Round 4 - Home Game C,Q,0,6880,6880,33:26.5,1
7/8/2021,20PNR4GC,2021 NBA Playoffs - Round 4 - Home Game C,Q,6880,10960,4080,17:22.4,2
7/8/2021,20PNR4GC,2021 NBA Playoffs - Round 4 - Home Game C,Q,10960,1270,-9690,34:56.5,3
7/8/2021,20PNR4GC,2021 NBA Playoffs - Round 4 - Home Game C,R,0,5590,5590,33:26.6,1
7/8/2021,20PNR4GC,2021 NBA Playoffs - Round 4 - Home Game C,R,5590,9740,4150,17:22.5,2
7/8/2021,20PNR4GC,2021 NBA Playoffs - Round 4 - Home Game C,R,9740,1130,-8610,34:56.5,3
7/8/2021,20PNR4GC,2021 NBA Playoffs - Round 4 - Home Game C,S,0,5590,5590,33:26.7,1
7/8/2021,20PNR4GC,2021 NBA Playoffs - Round 4 - Home Game C,S,5590,9740,4150,17:22.5,2
7/8/2021,20PNR4GC,2021 NBA Playoffs - Round 4 - Home Game C,S,9740,1130,-8610,34:56.5,3
7/8/2021,20PNR4GC,2021 NBA Playoffs - Round 4 - Home Game C,T,0,4730,4730,33:26.8,1
7/8/2021,20PNR4GC,2021 NBA Playoffs - Round 4 - Home Game C,T,4730,8030,3300,17:22.6,2
7/8/2021,20PNR4GC,2021 NBA Playoffs - Round 4 - Home Game C,T,8030,935,-7095,34:56.5,3
7/8/2021,20PNR4GC,2021 NBA Playoffs - Round 4 - Home Game C,U,0,3870,3870,33:26.9,1
7/8/2021,20PNR4GC,2021 NBA Playoffs - Round 4 - Home Game C,U,3870,7130,3260,17:22.7,2
7/8/2021,20PNR4GC,2021 NBA Playoffs - Round 4 - Home Game C,U,7130,825,-6305,34:56.5,3
7/8/2021,20PNR4GC,2021 NBA Playoffs - Round 4 - Home Game C,V,0,3440,3440,33:27.0,1
7/8/2021,20PNR4GC,2021 NBA Playoffs - Round 4 - Home Game C,V,3440,6430,2990,17:22.8,2
7/8/2021,20PNR4GC,2021 NBA Playoffs - Round 4 - Home Game C,V,6430,745,-5685,34:56.5,3
7/8/2021,20PNR4GC,2021 NBA Playoffs - Round 4 - Home Game C,W,0,3010,3010,33:27.1,1
7/8/2021,20PNR4GC,2021 NBA Playoffs - Round 4 - Home Game C,W,3010,6030,3020,17:22.9,2
7/8/2021,20PNR4GC,2021 NBA Playoffs - Round 4 - Home Game C,W,6030,700,-5330,34:56.5,3
7/8/2021,20PNR4GC,2021 NBA Playoffs - Round 4 - Home Game C,X,0,2795,2795,33:27.2,1
7/8/2021,20PNR4GC,2021 NBA Playoffs - Round 4 - Home Game C,X,2795,5370,2575,17:23.0,2
7/8/2021,20PNR4GC,2021 NBA Playoffs - Round 4 - Home Game C,X,5370,620,-4750,34:56.5,3
7/8/2021,20PNR4GC,2021 NBA Playoffs - Round 4 - Home Game C,Y,0,2795,2795,33:27.3,1
7/8/2021,20PNR4GC,2021 NBA Playoffs - Round 4 - Home Game C,Y,2795,5220,2425,17:23.1,2
7/8/2021,20PNR4GC,2021 NBA Playoffs - Round 4 - Home Game C,Y,5220,605,-4615,34:56.5,3
7/8/2021,20PNR4GC,2021 NBA Playoffs - Round 4 - Home Game C,Z,0,999999,999999,33:27.4,1
7/8/2021,20PNR4GC,2021 NBA Playoffs - Round 4 - Home Game C,Z,999999,20190,-979809,17:23.2,2
7/8/2021,20PNR4GC,2021 NBA Playoffs - Round 4 - Home Game C,Z,20190,2345,-17845,34:56.5,3
7/8/2021,20PNR4VC,2021 NBA Playoffs - Round 4 - Home Game C,1,0,15000,15000,37:26.6,1
7/8/2021,20PNR4VC,2021 NBA Playoffs - Round 4 - Home Game C,2,0,15000,15000,37:26.7,1
7/8/2021,20PNR4VC,2021 NBA Playoffs - Round 4 - Home Game C,3,0,15000,15000,37:26.8,1
7/8/2021,20PNR4VC,2021 NBA Playoffs - Round 4 - Home Game C,4,0,10910,10910,37:26.9,1
7/8/2021,20PNR4VC,2021 NBA Playoffs - Round 4 - Home Game C,5,0,4955,4955,37:27.0,1
7/8/2021,20PNR4VC,2021 NBA Playoffs - Round 4 - Home Game C,6,0,3710,3710,37:27.1,1
7/8/2021,20PNR4VC,2021 NBA Playoffs - Round 4 - Home Game C,A,0,3430,3430,37:27.2,1
7/8/2021,20PNR4VC,2021 NBA Playoffs - Round 4 - Home Game C,B,0,3120,3120,37:27.3,1
7/8/2021,20PNR4VC,2021 NBA Playoffs - Round 4 - Home Game C,C,0,2850,2850,37:27.4,1
7/8/2021,20PNR4VC,2021 NBA Playoffs - Round 4 - Home Game C,D,0,2730,2730,37:27.5,1
7/8/2021,20PNR4VC,2021 NBA Playoffs - Round 4 - Home Game C,E,0,2290,2290,37:27.6,1
7/8/2021,20PNR4VC,2021 NBA Playoffs - Round 4 - Home Game C,F,0,2170,2170,37:27.7,1
7/8/2021,20PNR4VC,2021 NBA Playoffs - Round 4 - Home Game C,G,0,1980,1980,37:27.8,1
7/8/2021,20PNR4VC,2021 NBA Playoffs - Round 4 - Home Game C,H,0,1830,1830,37:27.9,1
7/8/2021,20PNR4VC,2021 NBA Playoffs - Round 4 - Home Game C,I,0,1645,1645,37:28.0,1
7/8/2021,20PNR4VC,2021 NBA Playoffs - Round 4 - Home Game C,J,0,1520,1520,37:28.1,1
7/8/2021,20PNR4VC,2021 NBA Playoffs - Round 4 - Home Game C,K,0,1410,1410,37:28.2,1
7/8/2021,20PNR4VC,2021 NBA Playoffs - Round 4 - Home Game C,L,0,1385,1385,37:28.3,1
7/8/2021,20PNR4VC,2021 NBA Playoffs - Round 4 - Home Game C,M,0,1215,1215,37:28.4,1
7/8/2021,20PNR4VC,2021 NBA Playoffs - Round 4 - Home Game C,N,0,2005,2005,37:28.5,1
7/8/2021,20PNR4VC,2021 NBA Playoffs - Round 4 - Home Game C,O,0,1805,1805,37:28.6,1
7/8/2021,20PNR4VC,2021 NBA Playoffs - Round 4 - Home Game C,P,0,1590,1590,37:28.7,1
7/8/2021,20PNR4VC,2021 NBA Playoffs - Round 4 - Home Game C,Q,0,1270,1270,37:28.8,1
7/8/2021,20PNR4VC,2021 NBA Playoffs - Round 4 - Home Game C,R,0,1130,1130,37:28.9,1
7/8/2021,20PNR4VC,2021 NBA Playoffs - Round 4 - Home Game C,S,0,1130,1130,37:29.0,1
7/8/2021,20PNR4VC,2021 NBA Playoffs - Round 4 - Home Game C,T,0,935,935,37:29.1,1
7/8/2021,20PNR4VC,2021 NBA Playoffs - Round 4 - Home Game C,U,0,825,825,37:29.2,1
7/8/2021,20PNR4VC,2021 NBA Playoffs - Round 4 - Home Game C,V,0,745,745,37:29.3,1
7/8/2021,20PNR4VC,2021 NBA Playoffs - Round 4 - Home Game C,W,0,700,700,37:29.4,1
7/8/2021,20PNR4VC,2021 NBA Playoffs - Round 4 - Home Game C,X,0,620,620,37:29.5,1
7/8/2021,20PNR4VC,2021 NBA Playoffs - Round 4 - Home Game C,Y,0,605,605,37:29.6,1
7/8/2021,20PNR4VC,2021 NBA Playoffs - Round 4 - Home Game C,Z,0,2345,2345,37:29.7,1
7/11/2021,20PNR4GD,2021 NBA Playoffs - Round 4 - Home Game D,1,0,236500,236500,33:27.5,1
7/11/2021,20PNR4GD,2021 NBA Playoffs - Round 4 - Home Game D,1,236500,157500,-79000,17:23.2,2
7/11/2021,20PNR4GD,2021 NBA Playoffs - Round 4 - Home Game D,1,157500,15000,-142500,34:56.5,3
7/11/2021,20PNR4GD,2021 NBA Playoffs - Round 4 - Home Game D,2,0,98900,98900,33:27.6,1
7/11/2021,20PNR4GD,2021 NBA Playoffs - Round 4 - Home Game D,2,98900,15000,-83900,34:56.5,2
7/11/2021,20PNR4GD,2021 NBA Playoffs - Round 4 - Home Game D,3,0,85979,85979,33:27.7,1
7/11/2021,20PNR4GD,2021 NBA Playoffs - Round 4 - Home Game D,3,85979,157500,71521,17:23.4,2
7/11/2021,20PNR4GD,2021 NBA Playoffs - Round 4 - Home Game D,3,157500,15000,-142500,34:56.5,3
7/11/2021,20PNR4GD,2021 NBA Playoffs - Round 4 - Home Game D,4,0,47300,47300,33:27.8,1
7/11/2021,20PNR4GD,2021 NBA Playoffs - Round 4 - Home Game D,4,47300,114540,67240,17:23.5,2
7/11/2021,20PNR4GD,2021 NBA Playoffs - Round 4 - Home Game D,4,114540,10910,-103630,34:56.5,3
7/11/2021,20PNR4GD,2021 NBA Playoffs - Round 4 - Home Game D,5,0,43000,43000,33:27.8,1
7/11/2021,20PNR4GD,2021 NBA Playoffs - Round 4 - Home Game D,5,43000,59120,16120,17:23.5,2
7/11/2021,20PNR4GD,2021 NBA Playoffs - Round 4 - Home Game D,5,59120,5335,-53785,34:56.5,3
7/11/2021,20PNR4GD,2021 NBA Playoffs - Round 4 - Home Game D,5,5335,4955,-380,54:56.8,4
7/11/2021,20PNR4GD,2021 NBA Playoffs - Round 4 - Home Game D,5,5335,4955,-380,54:56.8,5
7/11/2021,20PNR4GD,2021 NBA Playoffs - Round 4 - Home Game D,6,0,30100,30100,33:28.0,1
7/11/2021,20PNR4GD,2021 NBA Playoffs - Round 4 - Home Game D,6,30100,41100,11000,17:23.6,2
7/11/2021,20PNR4GD,2021 NBA Playoffs - Round 4 - Home Game D,6,41100,3710,-37390,34:56.5,3
7/11/2021,20PNR4GD,2021 NBA Playoffs - Round 4 - Home Game D,7,23650,38610,14960,17:23.7,1
7/11/2021,20PNR4GD,2021 NBA Playoffs - Round 4 - Home Game D,7,38610,3485,-35125,34:56.5,2
7/11/2021,20PNR4GD,2021 NBA Playoffs - Round 4 - Home Game D,7,3485,3615,130,54:56.8,3
7/11/2021,20PNR4GD,2021 NBA Playoffs - Round 4 - Home Game D,7,3485,3615,130,54:56.8,4
7/11/2021,20PNR4GD,2021 NBA Playoffs - Round 4 - Home Game D,8,18275,32420,14145,17:23.8,1
7/11/2021,20PNR4GD,2021 NBA Playoffs - Round 4 - Home Game D,8,32420,3760,-28660,34:56.5,2
7/11/2021,20PNR4GD,2021 NBA Playoffs - Round 4 - Home Game D,9,17630,31260,13630,17:23.9,1
7/11/2021,20PNR4GD,2021 NBA Playoffs - Round 4 - Home Game D,9,31260,3625,-27635,34:56.5,2
7/11/2021,20PNR4GD,2021 NBA Playoffs - Round 4 - Home Game D,A,0,16770,16770,33:28.1,1
7/11/2021,20PNR4GD,2021 NBA Playoffs - Round 4 - Home Game D,A,16770,29570,12800,17:24.0,2
7/11/2021,20PNR4GD,2021 NBA Playoffs - Round 4 - Home Game D,A,29570,3430,-26140,34:56.5,3
7/11/2021,20PNR4GD,2021 NBA Playoffs - Round 4 - Home Game D,B,0,16125,16125,33:28.2,1
7/11/2021,20PNR4GD,2021 NBA Playoffs - Round 4 - Home Game D,B,16125,26880,10755,17:24.1,2
7/11/2021,20PNR4GD,2021 NBA Playoffs - Round 4 - Home Game D,B,26880,3120,-23760,34:56.5,3
7/11/2021,20PNR4GD,2021 NBA Playoffs - Round 4 - Home Game D,C,0,15050,15050,33:28.2,1
7/11/2021,20PNR4GD,2021 NBA Playoffs - Round 4 - Home Game D,C,15050,24590,9540,17:24.2,2
7/11/2021,20PNR4GD,2021 NBA Playoffs - Round 4 - Home Game D,C,24590,2850,-21740,34:56.5,3
7/11/2021,20PNR4GD,2021 NBA Playoffs - Round 4 - Home Game D,D,0,14190,14190,33:28.3,1
7/11/2021,20PNR4GD,2021 NBA Playoffs - Round 4 - Home Game D,D,14190,23530,9340,17:24.3,2
7/11/2021,20PNR4GD,2021 NBA Playoffs - Round 4 - Home Game D,D,23530,2730,-20800,34:56.5,3
7/11/2021,20PNR4GD,2021 NBA Playoffs - Round 4 - Home Game D,E,0,13330,13330,33:28.4,1
7/11/2021,20PNR4GD,2021 NBA Playoffs - Round 4 - Home Game D,E,13330,19750,6420,17:24.3,2
7/11/2021,20PNR4GD,2021 NBA Playoffs - Round 4 - Home Game D,E,19750,2290,-17460,34:56.5,3
7/11/2021,20PNR4GD,2021 NBA Playoffs - Round 4 - Home Game D,F,0,11395,11395,33:28.5,1
7/11/2021,20PNR4GD,2021 NBA Playoffs - Round 4 - Home Game D,F,11395,18710,7315,17:24.4,2
7/11/2021,20PNR4GD,2021 NBA Playoffs - Round 4 - Home Game D,F,18710,2170,-16540,34:56.5,3
7/11/2021,20PNR4GD,2021 NBA Playoffs - Round 4 - Home Game D,G,0,10965,10965,33:28.6,1
7/11/2021,20PNR4GD,2021 NBA Playoffs - Round 4 - Home Game D,G,10965,17090,6125,17:24.5,2
7/11/2021,20PNR4GD,2021 NBA Playoffs - Round 4 - Home Game D,G,17090,1980,-15110,34:56.5,3
7/11/2021,20PNR4GD,2021 NBA Playoffs - Round 4 - Home Game D,H,0,10535,10535,33:28.7,1
7/11/2021,20PNR4GD,2021 NBA Playoffs - Round 4 - Home Game D,H,10535,15770,5235,17:24.6,2
7/11/2021,20PNR4GD,2021 NBA Playoffs - Round 4 - Home Game D,H,15770,1830,-13940,34:56.5,3
7/11/2021,20PNR4GD,2021 NBA Playoffs - Round 4 - Home Game D,I,0,9030,9030,33:28.8,1
7/11/2021,20PNR4GD,2021 NBA Playoffs - Round 4 - Home Game D,I,9030,14180,5150,17:24.7,2
7/11/2021,20PNR4GD,2021 NBA Playoffs - Round 4 - Home Game D,I,14180,1645,-12535,34:56.5,3
7/11/2021,20PNR4GD,2021 NBA Playoffs - Round 4 - Home Game D,J,0,8385,8385,33:28.9,1
7/11/2021,20PNR4GD,2021 NBA Playoffs - Round 4 - Home Game D,J,8385,13080,4695,17:24.8,2
7/11/2021,20PNR4GD,2021 NBA Playoffs - Round 4 - Home Game D,J,13080,1520,-11560,34:56.5,3
7/11/2021,20PNR4GD,2021 NBA Playoffs - Round 4 - Home Game D,K,0,6880,6880,33:29.0,1
7/11/2021,20PNR4GD,2021 NBA Playoffs - Round 4 - Home Game D,K,6880,12160,5280,17:24.9,2
7/11/2021,20PNR4GD,2021 NBA Playoffs - Round 4 - Home Game D,K,12160,1410,-10750,34:56.5,3
7/11/2021,20PNR4GD,2021 NBA Playoffs - Round 4 - Home Game D,L,0,6450,6450,33:29.1,1
7/11/2021,20PNR4GD,2021 NBA Playoffs - Round 4 - Home Game D,L,6450,11930,5480,17:25.0,2
7/11/2021,20PNR4GD,2021 NBA Playoffs - Round 4 - Home Game D,L,11930,1385,-10545,34:56.5,3
7/11/2021,20PNR4GD,2021 NBA Playoffs - Round 4 - Home Game D,M,0,6020,6020,33:29.2,1
7/11/2021,20PNR4GD,2021 NBA Playoffs - Round 4 - Home Game D,M,6020,10470,4450,17:25.1,2
7/11/2021,20PNR4GD,2021 NBA Playoffs - Round 4 - Home Game D,M,10470,1215,-9255,34:56.5,3
7/11/2021,20PNR4GD,2021 NBA Playoffs - Round 4 - Home Game D,N,0,10105,10105,33:29.3,1
7/11/2021,20PNR4GD,2021 NBA Playoffs - Round 4 - Home Game D,N,10105,17290,7185,17:25.2,2
7/11/2021,20PNR4GD,2021 NBA Playoffs - Round 4 - Home Game D,N,17290,2005,-15285,34:56.5,3
7/11/2021,20PNR4GD,2021 NBA Playoffs - Round 4 - Home Game D,O,0,9460,9460,33:29.4,1
7/11/2021,20PNR4GD,2021 NBA Playoffs - Round 4 - Home Game D,O,9460,15550,6090,17:25.2,2
7/11/2021,20PNR4GD,2021 NBA Playoffs - Round 4 - Home Game D,O,15550,1805,-13745,34:56.5,3
7/11/2021,20PNR4GD,2021 NBA Playoffs - Round 4 - Home Game D,P,0,7740,7740,33:29.5,1
7/11/2021,20PNR4GD,2021 NBA Playoffs - Round 4 - Home Game D,P,7740,13670,5930,17:25.3,2
7/11/2021,20PNR4GD,2021 NBA Playoffs - Round 4 - Home Game D,P,13670,1590,-12080,34:56.5,3
7/11/2021,20PNR4GD,2021 NBA Playoffs - Round 4 - Home Game D,Q,0,6880,6880,33:29.6,1
7/11/2021,20PNR4GD,2021 NBA Playoffs - Round 4 - Home Game D,Q,6880,10960,4080,17:25.4,2
7/11/2021,20PNR4GD,2021 NBA Playoffs - Round 4 - Home Game D,Q,10960,1270,-9690,34:56.5,3
7/11/2021,20PNR4GD,2021 NBA Playoffs - Round 4 - Home Game D,R,0,5590,5590,33:29.7,1
7/11/2021,20PNR4GD,2021 NBA Playoffs - Round 4 - Home Game D,R,5590,9740,4150,17:25.5,2
7/11/2021,20PNR4GD,2021 NBA Playoffs - Round 4 - Home Game D,R,9740,1130,-8610,34:56.5,3
7/11/2021,20PNR4GD,2021 NBA Playoffs - Round 4 - Home Game D,S,0,5590,5590,33:29.8,1
7/11/2021,20PNR4GD,2021 NBA Playoffs - Round 4 - Home Game D,S,5590,9740,4150,17:25.6,2
7/11/2021,20PNR4GD,2021 NBA Playoffs - Round 4 - Home Game D,S,9740,1130,-8610,34:56.5,3
7/11/2021,20PNR4GD,2021 NBA Playoffs - Round 4 - Home Game D,T,0,4730,4730,33:29.8,1
7/11/2021,20PNR4GD,2021 NBA Playoffs - Round 4 - Home Game D,T,4730,8030,3300,17:25.7,2
7/11/2021,20PNR4GD,2021 NBA Playoffs - Round 4 - Home Game D,T,8030,935,-7095,34:56.5,3
7/11/2021,20PNR4GD,2021 NBA Playoffs - Round 4 - Home Game D,U,0,3870,3870,33:29.9,1
7/11/2021,20PNR4GD,2021 NBA Playoffs - Round 4 - Home Game D,U,3870,7130,3260,17:25.7,2
7/11/2021,20PNR4GD,2021 NBA Playoffs - Round 4 - Home Game D,U,7130,825,-6305,34:56.5,3
7/11/2021,20PNR4GD,2021 NBA Playoffs - Round 4 - Home Game D,V,0,3440,3440,33:30.1,1
7/11/2021,20PNR4GD,2021 NBA Playoffs - Round 4 - Home Game D,V,3440,6430,2990,17:25.8,2
7/11/2021,20PNR4GD,2021 NBA Playoffs - Round 4 - Home Game D,V,6430,745,-5685,34:56.5,3
7/11/2021,20PNR4GD,2021 NBA Playoffs - Round 4 - Home Game D,W,0,3010,3010,33:30.2,1
7/11/2021,20PNR4GD,2021 NBA Playoffs - Round 4 - Home Game D,W,3010,6030,3020,17:25.9,2
7/11/2021,20PNR4GD,2021 NBA Playoffs - Round 4 - Home Game D,W,6030,700,-5330,34:56.5,3
7/11/2021,20PNR4GD,2021 NBA Playoffs - Round 4 - Home Game D,X,0,2795,2795,33:30.3,1
7/11/2021,20PNR4GD,2021 NBA Playoffs - Round 4 - Home Game D,X,2795,5370,2575,17:26.0,2
7/11/2021,20PNR4GD,2021 NBA Playoffs - Round 4 - Home Game D,X,5370,620,-4750,34:56.5,3
7/11/2021,20PNR4GD,2021 NBA Playoffs - Round 4 - Home Game D,Y,0,2795,2795,33:30.4,1
7/11/2021,20PNR4GD,2021 NBA Playoffs - Round 4 - Home Game D,Y,2795,5220,2425,17:26.1,2
7/11/2021,20PNR4GD,2021 NBA Playoffs - Round 4 - Home Game D,Y,5220,605,-4615,34:56.5,3
7/11/2021,20PNR4GD,2021 NBA Playoffs - Round 4 - Home Game D,Z,0,999999,999999,33:30.5,1
7/11/2021,20PNR4GD,2021 NBA Playoffs - Round 4 - Home Game D,Z,999999,20190,-979809,17:26.2,2
7/11/2021,20PNR4GD,2021 NBA Playoffs - Round 4 - Home Game D,Z,20190,2345,-17845,34:56.5,3
7/11/2021,20PNR4VD,2021 NBA Playoffs - Round 4 - Home Game D,1,0,15000,15000,38:36.2,1
7/11/2021,20PNR4VD,2021 NBA Playoffs - Round 4 - Home Game D,2,0,15000,15000,38:36.3,1
7/11/2021,20PNR4VD,2021 NBA Playoffs - Round 4 - Home Game D,3,0,15000,15000,38:36.4,1
7/11/2021,20PNR4VD,2021 NBA Playoffs - Round 4 - Home Game D,4,0,10910,10910,38:36.5,1
7/11/2021,20PNR4VD,2021 NBA Playoffs - Round 4 - Home Game D,5,0,4955,4955,38:36.6,1
7/11/2021,20PNR4VD,2021 NBA Playoffs - Round 4 - Home Game D,6,0,3710,3710,38:36.7,1
7/11/2021,20PNR4VD,2021 NBA Playoffs - Round 4 - Home Game D,A,0,3430,3430,38:36.8,1
7/11/2021,20PNR4VD,2021 NBA Playoffs - Round 4 - Home Game D,B,0,3120,3120,38:36.9,1
7/11/2021,20PNR4VD,2021 NBA Playoffs - Round 4 - Home Game D,C,0,2850,2850,38:37.0,1
7/11/2021,20PNR4VD,2021 NBA Playoffs - Round 4 - Home Game D,D,0,2730,2730,38:37.1,1
7/11/2021,20PNR4VD,2021 NBA Playoffs - Round 4 - Home Game D,E,0,2290,2290,38:37.2,1
7/11/2021,20PNR4VD,2021 NBA Playoffs - Round 4 - Home Game D,F,0,2170,2170,38:37.3,1
7/11/2021,20PNR4VD,2021 NBA Playoffs - Round 4 - Home Game D,G,0,1980,1980,38:37.4,1
7/11/2021,20PNR4VD,2021 NBA Playoffs - Round 4 - Home Game D,H,0,1830,1830,38:37.5,1
7/11/2021,20PNR4VD,2021 NBA Playoffs - Round 4 - Home Game D,I,0,1645,1645,38:37.6,1
7/11/2021,20PNR4VD,2021 NBA Playoffs - Round 4 - Home Game D,J,0,1520,1520,38:37.7,1
7/11/2021,20PNR4VD,2021 NBA Playoffs - Round 4 - Home Game D,K,0,1410,1410,38:37.8,1
7/11/2021,20PNR4VD,2021 NBA Playoffs - Round 4 - Home Game D,L,0,1385,1385,38:37.9,1
7/11/2021,20PNR4VD,2021 NBA Playoffs - Round 4 - Home Game D,M,0,1215,1215,38:38.0,1
7/11/2021,20PNR4VD,2021 NBA Playoffs - Round 4 - Home Game D,N,0,2005,2005,38:38.1,1
7/11/2021,20PNR4VD,2021 NBA Playoffs - Round 4 - Home Game D,O,0,1805,1805,38:38.2,1
7/11/2021,20PNR4VD,2021 NBA Playoffs - Round 4 - Home Game D,P,0,1590,1590,38:38.3,1
7/11/2021,20PNR4VD,2021 NBA Playoffs - Round 4 - Home Game D,Q,0,1270,1270,38:38.4,1
7/11/2021,20PNR4VD,2021 NBA Playoffs - Round 4 - Home Game D,R,0,1130,1130,38:38.5,1
7/11/2021,20PNR4VD,2021 NBA Playoffs - Round 4 - Home Game D,S,0,1130,1130,38:38.7,1
7/11/2021,20PNR4VD,2021 NBA Playoffs - Round 4 - Home Game D,T,0,935,935,38:38.7,1
7/11/2021,20PNR4VD,2021 NBA Playoffs - Round 4 - Home Game D,U,0,825,825,38:38.9,1
7/11/2021,20PNR4VD,2021 NBA Playoffs - Round 4 - Home Game D,V,0,745,745,38:39.0,1
7/11/2021,20PNR4VD,2021 NBA Playoffs - Round 4 - Home Game D,W,0,700,700,38:39.1,1
7/11/2021,20PNR4VD,2021 NBA Playoffs - Round 4 - Home Game D,X,0,620,620,38:39.1,1
7/11/2021,20PNR4VD,2021 NBA Playoffs - Round 4 - Home Game D,Y,0,605,605,38:39.3,1
7/11/2021,20PNR4VD,2021 NBA Playoffs - Round 4 - Home Game D,Z,0,2345,2345,38:39.3,1
